오토_프랑크	안네_프랑크	child	에디트 프랑크는 《안네의 일기》의 저자  << _obj_ >> 와 언니 마르고트 프랑크의 어머니인 유대계 독일인 여성으로,  << _sbj_ >> 의 아내이다.
스트랫퍼드_(런던)	영국	country	배스킷볼 아레나는  << _obj_ >>  런던  << _sbj_ >>  퀸 엘리자베스 올림픽 공원 내에 있는 농구 경기 시설이다.
모스크바	러시아	country	 예를 들어서 미국에 있는 하와이, 뉴욕, 플로리다 뿐만 아니라 일본,  << _obj_ >> 의 수도인  << _sbj_ >> , 독일, 이탈리아, 멕시코, 프랑스, 케냐, 오스트레일리아, 영국, 중국 등 14가지 코스를 제공한다.
LG전자	대한민국	country	LG 뷰3 는  << _sbj_ >> 에서 2013년 9월 27일  << _obj_ >> 에서 출시한 안드로이드  스마트폰이다.
콜로라도_주	미국	country	덴버 너기츠는  << _obj_ >>   << _sbj_ >>  덴버를 연고지로 하는 1948년부터 1950년까지 내셔널 바스켓볼 리그 /전미 농구 협회 서부 디비전 소속되었던 프로농구 팀이다.
볼티모어	미국	country	볼티모어 불리츠는  << _obj_ >>  메릴랜드 주  << _sbj_ >> 를 연고지로 하는 1948년부터 1954년까지 전미 농구 협회 동부 디비전 소속되었던 프로농구 팀이다.
말레	몰디브	country	메가 몰디브는  << _obj_ >> 의 항공사로 2010년 설립되어  << _sbj_ >> 에 본사를 두고 있으며 말레 국제공항을 거점으로 운항하고 있다.
영천시	대한민국	country	칠백로는  << _obj_ >> 의 경상북도  << _sbj_ >>  대창면에서 시작하여, 남부동을 거쳐 도동삼거리까지 연결하는 도로이다.
빅토리아_주	오스트레일리아	country	동부막대무늬반디쿠트는  << _obj_ >>  남동부의 태즈메이니아 주와  << _sbj_ >> 에 서식하는 토끼 크기의 작은 유대류의 일종이다.
셰틀랜드_제도	스코틀랜드	country	투표 결과  << _obj_ >>  최북단 지역인  << _sbj_ >> 와 아우터헤브리디스를 제외하고 모든 지역에서 영국이 유럽공동체 존속에 '찬성'으로 돌아서기로 한 것으로 드러났다.
중구_(울산광역시)	대한민국	country	화합로는  << _obj_ >> 의 울산광역시 남구  여천동에서 시작하여,  << _sbj_ >>  복산동을 거쳐 연결하는 도로이다.
왕과_비	김종선_(연출자)	director	 그러나 수뢰 혐의로 연출에서 손을 떼자 KBS는  << _sbj_ >> 를 2000년 3월까지 연장하고 이 과정에서 왕과 비는 담당 PD  << _obj_ >> 이 <태조 왕건> 연출자로 발령되어 하차하는 대신 윤용훈-윤창범 공동연출로 변경됐다.
텍사스_주	미국	country	스푼은  << _obj_ >>   << _sbj_ >>  오스틴  출신 인디 록 밴드이다.
조비	조예	child	  << _sbj_ >> 의 손자이고,  << _obj_ >> 의 이복 동생인 동해정왕 조림 의 아들이며, 자 는 언사이다.
조비	조예	child	 삼국시대 위 는 조조,  << _sbj_ >> ,  << _obj_ >> 의 3대가 나란히 조의 묘호를 올렸으며, 남북조 시대와 오대 십국 시대의 국가들도 조를 올린 군주가 2명 이상인 국가가 많다.
조비	조예	child	  << _sbj_ >> 가 즉위한 후인 황초 연간에 당양장을 지내고 당시 평원왕의 봉작에 있던 명제  << _obj_ >> 의 부를 맡았다.
조비	조예	child	 실제로 유선이 촉의 황제로 재위하던 동안 위는  << _sbj_ >> ,  << _obj_ >> , 조방, 조모, 조환 등으로, 오는 손권, 손량, 손휴,손호 등으로 황제가 바뀌었다.
조비	조예	child	그러나 하안의 거리낌없고 추시부세적인 성정 때문에  << _sbj_ >> 와  << _obj_ >> 는 그를 중용하지 않았다.
조비	조예	successor	  << _sbj_ >> 의 손자이고,  << _obj_ >> 의 이복 동생인 동해정왕 조림 의 아들이며, 자 는 언사이다.
조비	조예	successor	 삼국시대 위 는 조조,  << _sbj_ >> ,  << _obj_ >> 의 3대가 나란히 조의 묘호를 올렸으며, 남북조 시대와 오대 십국 시대의 국가들도 조를 올린 군주가 2명 이상인 국가가 많다.
조비	조예	successor	  << _sbj_ >> 가 즉위한 후인 황초 연간에 당양장을 지내고 당시 평원왕의 봉작에 있던 명제  << _obj_ >> 의 부를 맡았다.
조비	조예	successor	 실제로 유선이 촉의 황제로 재위하던 동안 위는  << _sbj_ >> ,  << _obj_ >> , 조방, 조모, 조환 등으로, 오는 손권, 손량, 손휴,손호 등으로 황제가 바뀌었다.
조비	조예	successor	그러나 하안의 거리낌없고 추시부세적인 성정 때문에  << _sbj_ >> 와  << _obj_ >> 는 그를 중용하지 않았다.
손권	손량	child	부친 제갈근과 승상 육손 사후 병권을 잡아 대장군 벼슬을 받고  << _sbj_ >> 이 그의 막내아들  << _obj_ >> 을 태자로 삼자 태자태부로 삼아 후견인으로 삼았다.
손권	손량	child	  << _sbj_ >> 이 우연히 보고 후궁으로 들였으며, 회임하여 징조가 있는 꿈을 꾸고 손권의 막내아들  << _obj_ >> 을 낳았다.
손권	손량	child	 실제로 유선이 촉의 황제로 재위하던 동안 위는 조비, 조예, 조방, 조모, 조환 등으로, 오는  << _sbj_ >> ,  << _obj_ >> , 손휴,손호 등으로 황제가 바뀌었다.
손권	손량	child	어린 시절 전종의 부인이자  << _sbj_ >> 의 딸인 손노반의 총애를 받았고, 손대호는 전씨가 손권의 막내 아들인  << _obj_ >> 의 부인이 되도록 했다.
손권	손량	child	  << _sbj_ >> 은 죽을 때, 제갈각을 태자태부·대장군에 임명하여 어린  << _obj_ >> 을 보좌하게 했다.
손권	손량	successor	부친 제갈근과 승상 육손 사후 병권을 잡아 대장군 벼슬을 받고  << _sbj_ >> 이 그의 막내아들  << _obj_ >> 을 태자로 삼자 태자태부로 삼아 후견인으로 삼았다.
손권	손량	successor	  << _sbj_ >> 이 우연히 보고 후궁으로 들였으며, 회임하여 징조가 있는 꿈을 꾸고 손권의 막내아들  << _obj_ >> 을 낳았다.
손권	손량	successor	 실제로 유선이 촉의 황제로 재위하던 동안 위는 조비, 조예, 조방, 조모, 조환 등으로, 오는  << _sbj_ >> ,  << _obj_ >> , 손휴,손호 등으로 황제가 바뀌었다.
손권	손량	successor	어린 시절 전종의 부인이자  << _sbj_ >> 의 딸인 손노반의 총애를 받았고, 손대호는 전씨가 손권의 막내 아들인  << _obj_ >> 의 부인이 되도록 했다.
손권	손량	successor	  << _sbj_ >> 은 죽을 때, 제갈각을 태자태부·대장군에 임명하여 어린  << _obj_ >> 을 보좌하게 했다.
코나미	일본	country	팝픈뮤직은  << _obj_ >> 의  << _sbj_ >> 사에서 제작한 음악 게임으로, 비마니 시리즈 제2탄이다.
방콕	타이	country	짐 톰프슨의 집은  << _obj_ >>   << _sbj_ >> 에 있는 박물관이다.
수마트라_섬	인도네시아	country	펜단 산은  << _obj_ >>   << _sbj_ >> 에 있는 화산이다.
김일성	김정일	child	저널리스트 브래들리 마틴은 북한의  << _sbj_ >> 과  << _obj_ >> 이 행한 개인 숭배를 보도했다.
필리프_람	FC_바이에른_뮌헨	team	 카르바할은 분데스리가에서의 푸스발-분데스리가 2012-13에  << _obj_ >> 의  << _sbj_ >> 과 FC 샬케 04의 우치다 아쓰토의 뒤를 이어 최고의 우측 수비수 3명중 한명으로 선정되었다.
FIFA_클럽_월드컵_2014_결승전	CA_산로렌소	team	카르바할의 레알 마드리드는 같은 라 리가 소속의 세비야 FC와의 UEFA 슈퍼컵 2014 경기에서도 승리의 주역이 되었고, FIFA 클럽 월드컵 2014 FIFA 클럽 월드컵  << _sbj_ >> 에서도 아르헨티나의  << _obj_ >> 를 이겼다.
K팝스타_3	박진영	starring	 같은 달 17일 《 << _sbj_ >> 》에서 참가자 권진아는 어쿠스틱으로 편곡해 선보였고 원곡자이자 심사위원  << _obj_ >> 은 "미친 것 같다"며 극찬했다.
이스트서식스_주	영국	country	이스트본은  << _obj_ >>   << _sbj_ >> 에 위치한 도시이다.
효고_현	일본	country	스마 해수욕장은  << _obj_ >>   << _sbj_ >>  고베 시 스마 구에 해수욕장이다.
지다	사우디아라비아	country	이 바이러스는 이집트의 바이러스학자 알리 모하메드 자키 박사가  << _obj_ >>   << _sbj_ >> 의 급성 폐렴 및 급성 신부전 증세를 보이는 60세 남성의 허파에서 채취된 표본에서 발견되었다.
안데스_산맥	볼리비아	country	  << _sbj_ >>  동쪽 지역의 아르헨티나 북부와  << _obj_ >>  남부 산기숡에서 발견된다.
주오_구_(고베_시)	일본	country	구 고베 항 신호소는  << _obj_ >>  효고 현 고베 시  << _sbj_ >> 의 다카하마 여객 터미널 남단에 있는 역사적인 건물이다.
앨라배마_주	미국	country	첼시는  << _obj_ >>   << _sbj_ >>  셸비 군 의 도시이다.
베이루트	레바논	country	제14회 아시아 남자 핸드볼 선수권 대회는 2010년 2월 6일부터 19일까지  << _obj_ >>   << _sbj_ >> 에서 열렸다.
페르디난드_마르코스	필리핀	country	 또한  << _obj_ >> 에서는 열렬한 반공주의자이며, 독재자인  << _sbj_ >>  대통령을 계속 지원했다.
하이데라바드_(인도)	인도	country	제17회 세계 배드민턴 선수권 대회는 세계 배드민턴 연맹 주관으로 2009년 8월 10일에서 16일까지  << _obj_ >>   << _sbj_ >> 에서 열린 국제 배드민턴 대회이다.
오클라호마_주	미국	country	  << _obj_ >> 의 네브래스카 주, 노스다코타 주, 뉴멕시코 주, 몬태나 주, 사우스다코타 주,  << _sbj_ >> , 와이오밍 주, 캔자스 주, 콜로라도 주, 텍사스 주와 캐나다의 매니토바 주, 서스캐처원 주, 앨버타 주에 걸쳐있다.
사오싱_시	중화인민공화국	country	 2002년에는 대한민국 부산광역시에서, 2006년에는  << _obj_ >>  푸젠 성 샤먼 시에서, 2010년에는 중화인민공화국 저장 성  << _sbj_ >> 에서 합창 올림픽을 개최한 기록이 있었다.
사할린_섬	러시아	country	 동쪽으로 일본의 도호쿠 지방, 홋카이도와  << _obj_ >> 의  << _sbj_ >> , 서쪽으로 한반도의 함경북도, 함경남도, 강원도, 경상북도, 경상남도, 전라남도, 제주특별자치도, 남쪽으로 일본의 혼슈, 북쪽으로는 러시아의 프리모르스키 지방에 둘러싸여 있다.
케임브리지_대학교	영국	country	스티븐 윌리엄 호킹은 2009년까지  << _sbj_ >>  루커스 수학 석좌 교수로 재직한  << _obj_ >> 의 이론물리학자이다.
친황다오_시	중화인민공화국	country	진산 철로는 톈진 시와 허베이 성  << _sbj_ >>  산하이관 구를 연결하는,  << _obj_ >> 의 철도 노선이다.
뉘른베르크	독일	country	뉘른베르크 지하철은  << _obj_ >>   << _sbj_ >> 를 주행하는 지하철이다.
유희관	두산_베어스	team	 시리즈 MVP는  << _obj_ >> 의  << _sbj_ >> 이 차지했다.
큐_(런던)	영국	country	큐 왕립식물원은  << _obj_ >> 의 수도 런던 남서부의  << _sbj_ >> 에 있는 왕립식물원이다.
아이언맨_(영화)	테런스_하워드	starring	 배우 또한  << _sbj_ >> 에서는  << _obj_ >> 가 연기했으나, 아이언맨 2부터는 돈 치들이 연기했다.
조선_숙종	조선_경종	successor	유학의 일파인 양명학을 수학하여 학문적으로 강화학파를 구성하고, 정치적으로 소위 소론이라는 정치집단에 참여하여  << _sbj_ >> ,  << _obj_ >> , 조선 영조, 조선 정조때 노론의 패권주의, 부정부패에 대항하여 활약한 14 혹은 15 명의 관료 정치인이면서 동시에 지식인들을 일컫는다.
칼리_(콜롬비아)	콜롬비아	country	 1992년 12월에 에콰도르와  << _obj_ >> 와 노선통합 협정에 서명하면서 에스메랄다스 와  << _sbj_ >> 를 잇는 노선을 신설했다.
아마존_우림	볼리비아	country	  << _obj_ >> 와 브라질, 콜롬비아 그리고 페루의 상록  << _sbj_ >> 에서 발견된다.
북구_(울산광역시)	대한민국	country	송정초등학교는 울산광역시  << _sbj_ >>  화봉동에 있는  << _obj_ >> 의 공립 초등학교이다.
사와무라_히로카즈	요미우리_자이언츠	team	 이 가운데 스가노는 도카이 대학의 야구부 감독인 하라 미쯔구의 손자이며 숙부가 하라 다쓰노리  << _obj_ >>  감독이기 때문에 요미우리가 지명을 할 것이라는 소문이 공공연하게 나돌았으며, 이전 년도의  << _sbj_ >> 처럼 단독 지명이 확실시되었다.
조선_태종	조선_세종	child	원래의 위치는 전주시 풍남동이었으나, 이곳 남쪽에  << _sbj_ >>  10년에 조선 태조의 어진을 봉안하는 경기전이 지어지고,  << _obj_ >>  23년 "글 외고 읽는 소리, 회초리를 치는 소리 등이 시끌벅적하여 끊이지 않으므로 태조의 영령을 편안히 모실 수 없다"는 이유로 전주성 서쪽으로 6, 7리 떨어진 황학대 아래, 지금의 신흥중고등학교 부지로 옮겨 지었다.
하시모토_류타로	오부치_게이조	successor	 자유민주당 의 다나카 파벌에도 영향력이 컸는데, 당시 다나카파의 중진·신진 의원이었던  << _sbj_ >> 나  << _obj_ >> , 하다 쓰토무, 오자와 이치로 등은 그녀를 정계에서 어머니과 같다고 하며, 파벌이 갈린 후에도 “마마”라 부르며 그리워했다.
후지나미_신타로	한신_타이거스	team	한편 작년에 닛폰햄의 지명을 받았으나 입단을 거부하고 도카이 대학에서 일년을 재수한 스가노 도모유키는 요미우리 자이언츠의 단독 지명을 받았고, 2012년 봄·여름 고시엔 대회를 제패한 오사카 도인 고등학교의 주전투수인  << _sbj_ >> 는 한신, 오릭스 등 4개 구단에서 중복 지명을 받아 결국  << _obj_ >> 가 교섭권을 획득했다.
횡성군	대한민국	country	횡성시외버스터미널은 강원도   << _sbj_ >>  횡성읍 횡성로 379 에 위치한  << _obj_ >> 의 시외버스터미널이다.
사미_케디라	유벤투스_FC	team	 그의 형은  << _obj_ >>  소속으로 뛰고 있는 독일의 축구 선수인  << _sbj_ >> 이며 튀니지인 아버지와 독일인 어머니 사이에서 태어났다.
아산시	대한민국	country	봉수산은  << _obj_ >> 의 충청남도 예산군 대술면과  << _sbj_ >>  송악면, 공주시 유구읍 경계에 있는 산이다.
나라_현	일본	country	오미네 산은  << _obj_ >>   << _sbj_ >> 에 있는 산이며, 높이는 1천915m이다.
지치부_시	일본	country	가사토리 산은  << _obj_ >>  사이타마 현  << _sbj_ >> 와 야마나시 현 고슈 시 사이에 있는 높이 1천953m의 산이다.
하울링_(2012년_영화)	이나영	starring	 2001년에는 아마미 유키 주연으로, 2010년에는 기무라 요시노 주연으로 각각 드라마화되었으며, 2012년에는 대한민국에서 송강호,  << _obj_ >>  주연으로 《 << _sbj_ >> 》이라는 제목으로 영화화되었다.
시즈오카_현	일본	country	 후배들의 지도를 위해  << _obj_ >> 을 방문했다가 2013년 7월 10일 일본  << _sbj_ >> 에서 골프 라운드 도중 심장마비로 세상을 떠났다.
와다_쓰요시	후쿠오카_소프트뱅크_호크스	team	 2006년 9월 16일  << _obj_ >> 전에서는 8회초 1사 상황에서 그동안 무실점으로 막아내고 있던  << _sbj_ >> 로부터 동점 솔로 홈런을 때려내는 등 경기를 무승부로 만들었고 같은 달 24일의 사이타마 세이부 라이온스전에서는 선발이 아닌 경기 도중 출장이었지만 2개의 적시타를 때려내 팀 승리로 이끄는 등 종반에 상위 팀의 우승 전선을 흔들어놓는 활약도 빛났다.
대한민국_중앙정보부	대한민국_국가안전기획부	successor	국가안전기획부 운영차장실 또는 운영차장보실은  << _sbj_ >> 와  << _obj_ >> 의 예하 기관으로 대한민국 중앙정보부와 안기부의 인사, 예산 운영, 편성 등을 하였다.
비보발렌티아_현	이탈리아	country	세라산브루노는  << _obj_ >>  칼라브리아 주  << _sbj_ >> 에 위치한 도시이다.
서재필	뮤리엘_제이슨	child	  << _sbj_ >>  사후 화가였던 둘째 딸  << _obj_ >> 이 살았고 만년에는 그의 언니이자 서재필의 다른 딸 스테파니 보이드 제이슨도 이곳에서 함께 여생을 보냈다.
FIFA_월드컵	FIFA	country	 카탈루냐 축구 연맹이  << _obj_ >> 와 UEFA에 소속되어 있지 않기 때문에,  << _sbj_ >> 이나 UEFA 유럽 축구 선수권 대회를 비롯한 국제 대회에 참가할 수 없다.
할렘	미국	country	슈거힐은  << _obj_ >>  뉴욕 주 뉴욕 맨해튼 북부  << _sbj_ >>  서쪽에 있는 지역 이름의 통칭이다.
야마가타_아리토모	이토_히로부미	successor	 1900년 9월 15일에 입헌정우회가 결성되면서 일본의 내각총리대신  << _sbj_ >> 가 창당 직후의 입헌정우회를 흔들기 위해서 총재에 취임한  << _obj_ >> 에게 강제로 정권을 강요하는 형태로 성립하였다.
샤프_(기업)	일본	country	아쿠오스 폰 SHL22는 2013년 7월 하순,  << _sbj_ >> 의 << _obj_ >>  국내용으로 출시되는 스마트폰이다.
모창민	NC_다이노스	team	 5월 23일에도 이재학 의 호투와 권희동의 솔로포,  << _sbj_ >> 의  << _obj_ >>  창단 첫 연타석 홈런으로 SK 와이번스를 6-2로 꺾고 승리하였다.
카르타고	튀니지	country	고대 카르타고는 기원전 814년경에 현재의  << _obj_ >>  영토에 세워진 북아프리카의 도시국가  << _sbj_ >> 를 중심으로 발전한 셈족 문명이다.
육영수	박근혜	child	 박정희의 부인  << _sbj_ >> 의 작은할아버지이며,  << _obj_ >> 의 외종증조부가 된다.
육영수	박근혜	child	 또한 대한민국에서는 1974년 8월 15일 박정희 대통령의 부인인  << _sbj_ >>  여사가 총상으로 사망하자 대통령의 딸인  << _obj_ >> 가 퍼스트 레이디 대행을 박정희 대통령이 총상으로 사망할 때까지 수행하였다.
육영수	박근혜	successor	 박정희의 부인  << _sbj_ >> 의 작은할아버지이며,  << _obj_ >> 의 외종증조부가 된다.
육영수	박근혜	successor	 또한 대한민국에서는 1974년 8월 15일 박정희 대통령의 부인인  << _sbj_ >>  여사가 총상으로 사망하자 대통령의 딸인  << _obj_ >> 가 퍼스트 레이디 대행을 박정희 대통령이 총상으로 사망할 때까지 수행하였다.
밤의_열기_속으로_(1985년_영화)	장길수	director	1985년  << _sbj_ >>  = 감독  << _obj_ >>
연산일기	임권택	director	1988년  << _sbj_ >>  = 감독  << _obj_ >>
비슈케크	키르기스스탄	country	키르기스스탄 국립대학교는  << _obj_ >>   << _sbj_ >> 에 위치한 대학교이다.
베를린_장벽	동독	country	 특히  << _obj_ >> 은 1961년에  << _sbj_ >> 을 만들기 전까지 많은 사람들이 서독으로 갔기 때문에 1961년까지 인구가 크게 줄어들었다.
상트르발드루아르	프랑스	country	오를레앙은  << _obj_ >> 의 도시이며  << _sbj_ >>  레지옹과 루아레 주의 중심 도시이다.
쇼이쿠_왕	쇼타이_왕	child	쇼하시 왕 → 쇼추 왕 → 쇼시들 →  → 쇼엔 왕 → 쇼센 왕 → 쇼신 왕 → 중략 →  << _sbj_ >>  →  << _obj_ >>
쇼이쿠_왕	쇼타이_왕	successor	쇼하시 왕 → 쇼추 왕 → 쇼시들 →  → 쇼엔 왕 → 쇼센 왕 → 쇼신 왕 → 중략 →  << _sbj_ >>  →  << _obj_ >>
알래스카_주	미국	country	그러나 아시아의 동쪽 끝인 시베리아의 축치 반도와  << _obj_ >> 의  << _sbj_ >> 에 속해 있는 알류샨 열도는 이 기준선의 양쪽에 걸쳐 있기 때문에 축치 반도 쪽의 날짜 변경선은 동쪽으로 경도 10도 이상 꺾여 베링 해협을 지나고, 알류샨 열도에서는 서쪽으로 경도 10도 가까이 꺾여 있다.
J리그	일본	country	그는 2008-09 시즌이 끝나자 자유 계약으로 스페인 프리메라리가의 RCD 에스파뇰으로 이적하였으나 리그에 적응하지 못하며 주전 경쟁에서 밀리게 되었고, 2010년 2월 자신의 친정팀인  << _sbj_ >> 의 요코하마 F. 마리노스로 이적하여  << _obj_ >>  무대로 복귀하였다.
마이_웨이_(2011년_영화)	판빙빙	starring	2010년 10월부터 강제규 감독의  << _sbj_ >>  촬영중. 장동건,  << _obj_ >>  등과 함께 출연.
타스쿠얼간_타지크_자치현	중화인민공화국	country	카라코람 회랑은  << _obj_ >> 이 실효 지배하여 예청 현과  << _sbj_ >> 에 편재된 지역으로 인도와의 영토 분쟁 지역이다.
김영삼	이회창	successor	 한편 미림팀의 도청은  << _sbj_ >> 과 정치적으로 갈등하던  << _obj_ >>  등에게도 불이익이 가해졌다.
마오쩌둥	저우언라이	successor	  << _obj_ >>  총리는 한국전쟁에서 붙잡은 미국 공군 조종사 등 고위급 포로 11명을 넘기는 '빅딜'을 통해 1955년에 첸 박사를 귀국시켰고,  << _sbj_ >> 은 첸 박사에게 로켓과 미사일 개발에 관한 전권을 줘 '양탄일성' 개발을 이끌어냈다.
베네치아	이탈리아	country	물이 많아 축복받은 아름다운 나라.  << _obj_ >> 의  << _sbj_ >> 가 모티브.
신륵사	경기도	country	여주 신륵사 보제존자석종비는  << _obj_ >>  여주시,  << _sbj_ >>  사찰에 있는 고려시대의 비석이다.
박종찬	수원_FC	team	  << _sbj_ >> 과 함께  << _obj_ >> 의 전설적인 선수들 중 한 명으로 꼽힌다.
만포시	조선민주주의인민공화국	country	송삼역은  << _obj_ >>  자강도  << _sbj_ >> 에 위치한 북부철길의 역이다.
리카르도_알바레스	UC_삼프도리아	team	 코바치치는 2-0으로 이긴  << _obj_ >> 와의 다음 세리에 A 원정 경기에 출전했고, 주세페 메아차에서 3-4 충격패를 당한 아탈란타 BC전에도 출전해  << _sbj_ >> 의 골을 도왔다.
산마리노_(도시)	산마리노	country	SP 트레 펜네는  << _sbj_ >> 를 연고로 하는  << _obj_ >> 의 축구팀이다.
동화사	대구광역시	country	대구 동화사 비로암 석조비로자나불좌상은  << _obj_ >>  동구 ,  << _sbj_ >>  사찰에 있는 통일신라의 불상이다.
윤지웅	LG_트윈스	team	 이에  << _obj_ >> 에서는 보상 선수로 경찰 야구단 입대가 확정된 좌투  << _sbj_ >> 을 지명했다.
KBO_리그	KIA_타이거즈	team	한기주는  << _sbj_ >>   << _obj_ >> 의 투수이다.
프랑수아_미테랑	자크_시라크	successor	드골의 퇴진 후 1969년 9월 조르주 퐁피두 총리가 제2대 대통령에 당선되었으나 1974년 급서했으며, 1974년에 발레리 지스카르데스탱이 제3대 대통령에, 1981년 5월 사회당의  << _sbj_ >> 이 제21대 대통령에, 1995년에는 신 드골주의자  << _obj_ >> 가 제22대 대통령에 취임했으며 2007년 5월에는 니콜라 사르코지가 제23대 대통령에 당선되었다.
연남건	고구려	country	 문무왕 4년 7월에 문무왕의 명으로 장군 김인문·김품일 등과 함께 일선·한산 2주의 군사를 거느리고 웅진도독부와 함께  << _obj_ >> 의 돌사성을 쳐서 함락시켰으며, 문무왕 8년에 대아찬으로서 아찬 복세와 함께 비열성주행군총관으로 임명되어 고구려 공격에 나섰고, 이때 평양 근교의 사천 벌판에서 고구려의 태대막리지  << _sbj_ >> 의 군사와 교전하여 대승을 거두었다.
일본_프로_야구	요미우리_자이언츠	team	에가와 사건은 1978년  << _sbj_ >>  드래프트 회의 전날에 프로 야구 센트럴 리그 팀인  << _obj_ >> 와 전격으로 입단 계약을 맺은 에가와 스구루의 거취를 둘러싼 일련의 소동이다.
무냐노디나폴리	이탈리아	country	라파엘레 팔라디노는  << _obj_ >>   << _sbj_ >>  출신의 이탈리아 축구 선수로서 포지션은 공격수이다.
재팬_뉴스_네트워크	일본	country	《TAKE FIVE~우리는 사랑을 훔칠 수 있을까~》는, 2013년 4월 19일부터 6월 22일까지 도쿄 방송 홀딩스  << _sbj_ >> 의 TBS 금요드라마 시간대에서 방송된  << _obj_ >> 의 일본 드라마이다.
샤를루아	벨기에	country	1894년 7월 17일  << _obj_ >>   << _sbj_ >> 에서 태어났다.
경북대학교	대한민국	country	이열희는  << _obj_ >> 의 의학 교육자, 치과 의사, 구강 성형외과 의사, 대학 교수 및 예비역 대한민국 육군 대위이자  << _sbj_ >>  치의과대학 창립 멤버의 한 사람이며, 치과, 악안면외과 전문의였다.
이와테_현	일본	country	히라이즈미는,  << _obj_ >>   << _sbj_ >>  남서부에 있는 옛 지명으로 오늘날의 히라이즈미 정의 중심부에 해당한다.
조지_4세	윌리엄_4세	successor	 에른스트 아우구스트는  << _sbj_ >> 와  << _obj_ >> 의 동생으로서, 조지 3세의 당시까지 생존한 아들들 중 가장 연장자였다.
노태우	대한민국	country	한민족공동체통일방안은 1989년 9월 11일  << _obj_ >> 의 대한민국 국회에서  << _sbj_ >>  대통령 특별선언을 통해 발표되었다.
안도라라베야	안도라	country	루시타노스는  << _sbj_ >> 를 연고로 하는  << _obj_ >> 의 축구팀이다.
주오_구_(삿포로_시)	일본	country	삿포로 TV탑은  << _obj_ >>  홋카이도 삿포로 시  << _sbj_ >> 에 있는 지상 147.2미터의 텔레비전 전파탑이다.
솔즈베리_(메릴랜드_주)	미국	country	솔즈베리 대학교는  << _obj_ >>  메릴랜드 주  << _sbj_ >> 에 위치한 공립 대학교이다.
헨리_2세	리처드_1세	child	 15살 되던 1173년 친형 청년왕 헨리, 사자심왕  << _obj_ >> 와 함께 아버지  << _sbj_ >> 에 대한 반란을 일으켰다가 실패했다.
헨리_2세	리처드_1세	child	아버지  << _sbj_ >>  사후 동생들인  << _obj_ >> 와 존 이 차례로 영국의 군주위에 올랐다.
헨리_2세	리처드_1세	child	 아키텐 공작 기욤 10세 의 딸로 태어나 여상속자가 되었고, 프랑스 왕 루이 7세의 왕비였으며, 잉글랜드 왕  << _sbj_ >> 의 왕비이고, 헨리 2세의 아들 잉글랜드의  << _obj_ >> 와 존 을 낳은 모후이기도 하다.
헨리_2세	리처드_1세	successor	 15살 되던 1173년 친형 청년왕 헨리, 사자심왕  << _obj_ >> 와 함께 아버지  << _sbj_ >> 에 대한 반란을 일으켰다가 실패했다.
헨리_2세	리처드_1세	successor	아버지  << _sbj_ >>  사후 동생들인  << _obj_ >> 와 존 이 차례로 영국의 군주위에 올랐다.
헨리_2세	리처드_1세	successor	 아키텐 공작 기욤 10세 의 딸로 태어나 여상속자가 되었고, 프랑스 왕 루이 7세의 왕비였으며, 잉글랜드 왕  << _sbj_ >> 의 왕비이고, 헨리 2세의 아들 잉글랜드의  << _obj_ >> 와 존 을 낳은 모후이기도 하다.
사마염	서진_혜제	child	 위 의 통사랑 양병 의 딸이자  << _sbj_ >> 의 첫 번째 황후가 되며,  << _obj_ >> 의 어머니이다.
사마염	서진_혜제	child	 그러나  << _sbj_ >> 은 태자  << _obj_ >> 을 생각하고 있었기에 이를 못마땅하게 여겼다.
사마염	서진_혜제	successor	 위 의 통사랑 양병 의 딸이자  << _sbj_ >> 의 첫 번째 황후가 되며,  << _obj_ >> 의 어머니이다.
사마염	서진_혜제	successor	 그러나  << _sbj_ >> 은 태자  << _obj_ >> 을 생각하고 있었기에 이를 못마땅하게 여겼다.
벨라조	이탈리아	country	 호텔 이름은  << _obj_ >> 의 도시  << _sbj_ >> 에서 유래하였다.
연애소설_(영화)	손예진	starring	제작진은 김희선을 여주인공 1순위로 생각했으나 CF 스케줄 등의 이유로 포기하자  << _obj_ >> 을 2순위로 낙점시켰지만 영화  << _sbj_ >>  촬영 문제로 거절했고 우여곡절 끝에 장나라가 대타로 들어갔다.
즐라탄_이브라히모비치	AC_밀란	team	전성기 시절의 체중으로 돌아간 그에게 당시 호비뉴와  << _sbj_ >> 를 영입하며 연봉 규모를 줄여야 하는 처지인  << _obj_ >> 이 연봉의 50%를 삭감하여 재계약을 제의하자 거절하였다.
마리아_(예수의_어머니)	예수	child	푸른색:  << _sbj_ >> 를  << _obj_ >> 의 어머니로 공경하는 축일에 사용가능함.
윤웅렬	윤치왕	child	  << _sbj_ >> 의 아들  << _obj_ >> 과 윤영렬의 아들 윤치영, 윤영렬의 손자인 윤일선과 윤보선 등이 전동장에서 출생하였다.
조선_세종	조선_문종	successor	 따라서  << _sbj_ >> 의 처남이며  << _obj_ >> , 조선 세조에게는 외숙부가 된다.
중앙대학교	대한민국	country	이용구는  << _obj_ >> 의 경제학자이자  << _sbj_ >>  총장인 교육자이다.
동아시아	중화민국	country	아시아의 네 마리 용, 또는 아시아의 네 마리 호랑이는 아시아에서 일본에 이어 근대화에 성공하고, 제2차 세계 대전 이후 경제가 급속도로 성장한  << _sbj_ >> 의 네 국가에 해당하는 대한민국, 홍콩, 싱가포르,  << _obj_ >> 을 일컫는 말이다.
파티마_(포르투갈)	포르투갈	country	1917년, 마리아 가  << _obj_ >> 의  << _sbj_ >> 에 있는 3명의 어린이들에게 출현하여 인류에게 수많은 경고를 주었다.
2012_UEFA_챔피언스리그_결승전	FC_바이에른_뮌헨	team	 디 마테오 감독 하의 첼시는 FA컵 에서 우승을 거두었으며, UEFA 챔피언스리그  << _sbj_ >> 에 진출하여 승부차기에서  << _obj_ >> 을 4-3으로 꺾고 구단 역사상 최초의 챔피언스리그 타이틀을 획득하였다.
UEFA_유로파리그_2012-13	SL_벤피카	team	 베니테스의 첼시는  << _sbj_ >>  결승에 진출하여  << _obj_ >> 를 2-1로 물리치고 우승 타이틀을 차지하였다.
포돌스크	러시아	country	오스타피예보 국제공항은  << _obj_ >>  모스크바 주  << _sbj_ >> 에 있는 국제공항으로 주로 비즈니스 항공편을 처리하는 역할을 한다.
이르쿠츠크	러시아	country	국제공항 이르쿠츠크는  << _obj_ >>   << _sbj_ >> 에 있는 국제공항으로 주로 전세편 노선이 위주로 활발한 편이다.
사립_바카레아_고교	자니스_주니어	starring	  << _obj_ >> 인 타나카 쥬리와 제시 는 전 쿨의 동 시간대 드라마 《 << _sbj_ >> 》에 이어 이번 작품에서도 공동 출연하고 있다.
아르고_(영화)	벤_애플렉	starring	 2012년에는 테리오가 쓴 각본 《 << _sbj_ >> 》가 워너 브라더스 제작,  << _obj_ >>  감독 · 제작 · 주연, 조지 클루니 제작으로 완성되었다.
아르고_(영화)	벤_애플렉	starring	 알레한드로 곤살레스 이냐리투 감독의 초기작 《바벨 》, 《비우티풀》과 커티스 핸슨의 《8마일》, 리안의 《브로크백 마운틴》, 《색, 계》,  << _obj_ >> 의 《 << _sbj_ >> 》, 마틴 스코세이지의 《더 울프 오브 월 스트리트》의 촬영을 담당했다.
아르고_(영화)	벤_애플렉	starring	 데이비드 S. 고이어와 스토리를 쓰고, 《 << _sbj_ >> 》로 알려진 크리스 테리오가 각본을 썼으며, 이 영화에는 헨리 카빌,  << _obj_ >> , 에이미 애덤스, 제시 아이젠버그, 다이앤 레인, 로런스 피시번, 제러미 아이언스, 홀리 헌터와 갈 가도트가 출연했다.
아르고_(영화)	벤_애플렉	director	 2012년에는 테리오가 쓴 각본 《 << _sbj_ >> 》가 워너 브라더스 제작,  << _obj_ >>  감독 · 제작 · 주연, 조지 클루니 제작으로 완성되었다.
아르고_(영화)	벤_애플렉	director	 알레한드로 곤살레스 이냐리투 감독의 초기작 《바벨 》, 《비우티풀》과 커티스 핸슨의 《8마일》, 리안의 《브로크백 마운틴》, 《색, 계》,  << _obj_ >> 의 《 << _sbj_ >> 》, 마틴 스코세이지의 《더 울프 오브 월 스트리트》의 촬영을 담당했다.
아르고_(영화)	벤_애플렉	director	 데이비드 S. 고이어와 스토리를 쓰고, 《 << _sbj_ >> 》로 알려진 크리스 테리오가 각본을 썼으며, 이 영화에는 헨리 카빌,  << _obj_ >> , 에이미 애덤스, 제시 아이젠버그, 다이앤 레인, 로런스 피시번, 제러미 아이언스, 홀리 헌터와 갈 가도트가 출연했다.
UEFA_유로_2000_결승전	프랑스_축구_국가대표팀	team	 이 대회는 벨기에와 네덜란드에서 열리고 6월 10일에 시작되어  << _sbj_ >> 은 7월 2일에 로테르담에서 열려  << _obj_ >> 의 다비드 트레제게가 연장전에 골든골을 넣어 극적인 우승으로 막을 내렸다.
UEFA_유로_2012_결승전	스페인_축구_국가대표팀	team	 이 대회는 폴란드와 우크라이나에서 열리고 6월 8일에 시작되어  << _sbj_ >> 은 7월 1일에 키예프에서 열려  << _obj_ >> 의 우승으로 막을 내렸다.
이승재_(야구_선수)	NC_다이노스	team	 2013년 5월 25일 팀 동료인 윤병호 , 이원재 ,  << _sbj_ >> 와  << _obj_ >> 에 입단했고, 5월 31일에 합류 하였다.
신사임당	이이	child	 기념관에는  << _obj_ >> 와 그의 어머니  << _sbj_ >> 의 유물이 전시돼 있고 인근에 율곡교원연수원과 두루뫼박물관 및 술이홀통일박물관이 있다.
고분_천황	덴무_천황	successor	오미노 미후네 는 일본 나라 시대 후기의 문인으로, 임신의 난으로  << _obj_ >> 에게 패하고 쫓겨나 자결한  << _sbj_ >> 의 증손자이다.
대한민국_외자구매처	대한민국_외자청	successor	 1949년 12월 19일 발족하였으며 1955년 2월 7일  << _sbj_ >> 와 통합하여  << _obj_ >> 으로 개편되면서 폐지되었다.
인스브루크	오스트리아	country	라텐베르크는  << _obj_ >>  티롤 주에 위치한 마을로 인 강에 위치하며  << _sbj_ >> 와 가깝다.
라리가	스페인	country	마리오 수아레스 마타  는  << _obj_ >> 의 프로 축구 선수로, 현재  << _sbj_ >> 의 발렌시아 CF에서 중앙 미드필더로 활약하고 있다.
20세기_폭스	미국	country	폭스 플라자는  << _obj_ >>  로스앤젤레스 센추리시티에 있는 마천루로, 영화사  << _sbj_ >> 의 본사 건물이다.
카림_벤제마	레알_마드리드_CF	team	 2011년 11월 26일, 쿠르투아는  << _obj_ >> 전에서  << _sbj_ >> 에 파울을 범하며 프로 데뷔 이후로는 첫 퇴장을 당하였고, 아틀레티코는 엘 데르비 마드릴레뇨에서 1-4로 패하였다.
이홍장	위안스카이	successor	 카츠의 계획은 청나라의 실력자  << _sbj_ >> 과 접촉하여 조선에서 섭정을 하고 있는  << _obj_ >> 를 몰아내고 김옥균을 복권시켜 동아시아 3국 간의 균형을 맞춘다는 것이었다.
바니모	파푸아뉴기니	country	산다운 주는  << _obj_ >>  최북서단에 위치한 주로 주도는  << _sbj_ >> 이며 면적은 36,300㎢, 인구는 185,741명이다.
웨와크	파푸아뉴기니	country	동세픽 주는  << _obj_ >> 의 주로 주도는  << _sbj_ >> 이며 면적은 약 42,800㎢, 인구는 343,180명이다.
동세픽_주	파푸아뉴기니	country	웨와크는  << _obj_ >>   << _sbj_ >> 의 주도로, 뉴기니 섬 북해안에 위치하며 마당 과 인도네시아 자야푸라 사이에 있는 도시 가운데 가장 큰 도시이다.
러더퍼드_B._헤이스	미국	country	1876년 미국 하원의원 선거는 1876년  << _obj_ >> 에서 치러진 하원의원 선거로, 1876년 미국 대통령 선거에서 득표로는 민주당의 새뮤얼 J. 틸던이 이겼으나 선거인단 투표에서 공화당의  << _sbj_ >> 가 1표 차이로 승리했으나, 하원에서는 민주당이 승리하여 여소야대가 되었다
스트로베리_나이트_(드라마)	다케우치_유코	starring	 혼다 테쓰야의 경찰 소설 시리즈 〈히메카와 레이코 시리즈〉를 원작으로 하는 후지 TV의 형사 드라마 《 << _sbj_ >> 》의 극장판 작품. 감독은 사토 유이치, 주연은  << _obj_ >> .
텔아비브	이스라엘	country	1997년 2월 26일, 그는 독일 축구 국가대표팀 대표로  << _obj_ >>   << _sbj_ >> 에서 열린 이스라엘 축구 국가대표팀전에 처음으로 출전하였다.
이상화_(스피드_스케이팅_선수)	대한민국	country	 2012년 시즌부터  << _obj_ >>  국가대표팀 단거리 코치로 활동하면서,  << _sbj_ >>  등을 지도하고 있다.
흐브스글_주	몽골	country	므릉 공항은  << _obj_ >>   << _sbj_ >>  므릉에 있는 공항으로 훈누 에어 등을 통해 울란바타르로 가는 항공편을 이용할 수 있다.
죄르모숀쇼프론_주	헝가리	country	 슈바르차 강과 피텐 강이 오스트리아 니더외스터라이히 주 란첸키르셴에서 만나  << _obj_ >>   << _sbj_ >> 에서 다뉴브 강을 만난다.
마곡사	충청남도	country	공주 마곡사 대광보전은  << _obj_ >>  공주시 사곡면 마곡사로 966,  << _sbj_ >>  에 있는 조선 후기의 건물이다.
대한민국_과학기술부	대한민국_교육과학기술부	successor	2008년 02월 29일: 대한민국 지식경제부로 개편.  << _sbj_ >> 로부터 일부 소관사무를, 대한민국 정보통신부로부터 정보통신·전파관리·우편·우편환 및 우편대체에 관한 사무를 이관받음. 산업기술인력 양성에 관한 사무를  << _obj_ >> 로, 전파·통신에 관한 사무를 대한민국 방송통신위원회로 이관.
대한민국_교육인적자원부	대한민국_교육과학기술부	successor	2008년 02월 29일: 과학기술부와  << _sbj_ >> 를 통합하여  << _obj_ >> 를 설치. 대한민국 산업자원부로부터 산업기술인력 양성에 관한 사무를 이관받음. 정보통신부를 대한민국 방송통신위원회로 개편.
자와할랄_네루	인디라_간디	child	《세계사 편력》은 1930년 10월 26일부터 1933년 9월 8일까지 약 3년 동안  << _sbj_ >> 가 옥중 생활을 하면서 그의 외동딸  << _obj_ >> 에게 쓴 196회분의 편지를 책자로써 묶은 책이다.
은하수를_여행하는_히치하이커를_위한_안내서_(영화)	마틴_프리먼	starring	 1979년에 켄 캠프벨이 안내서를 무대에 올릴 때, Chris Langham이 부분을 맡았고,  << _sbj_ >> 에서는  << _obj_ >> 이 아서 역할을 맡았다.
미인도_(영화)	김영호_(배우)	starring	2008년 《 << _sbj_ >> 》-  << _obj_ >>
투생_루베르튀르	장자크_드살린	successor	  << _sbj_ >> ,  << _obj_ >> , 앙리 크리스토프 등이 이끄는 흑인 반군은 백인 지주를 처형한 뒤 프랑스에 선전 포고를 했다.
금와왕	대소왕	child	 주몽은  << _obj_ >>  등  << _sbj_ >> 의 7명의 아들보다 능력이 출중하여 그들의 시기를 받았고, 호시탐탐 그를 죽이려 하였다.
금와왕	대소왕	successor	 주몽은  << _obj_ >>  등  << _sbj_ >> 의 7명의 아들보다 능력이 출중하여 그들의 시기를 받았고, 호시탐탐 그를 죽이려 하였다.
프레데리크_2세	크리스티안_4세	child	크리스티안 3세 때는 원로원 등 귀족세력의 강화를 바탕으로 해서 경제의 발전 및 학자의 배출 등 국가번영의 기운을 보였으나, 그 후  << _sbj_ >>  때 발트해의 주도권을 놓고 덴마크·스웨덴·폴란드·뤼벡 사이에 ‘북방 7년전쟁’이 일어났고,  << _obj_ >>  때는 2차에 걸친 스웨덴과의 싸움으로 국토의 손실과 국력의 쇠퇴를 가져왔다.
프레데리크_2세	크리스티안_4세	child	  << _sbj_ >> 는 외할아버지,  << _obj_ >> 는 외숙부에 해당한다.
프레데리크_2세	크리스티안_4세	child	 덴마크와 노르웨이의 왕  << _sbj_ >> 의 둘째 딸이며  << _obj_ >> 의 누나이다.
프레데리크_2세	크리스티안_4세	successor	크리스티안 3세 때는 원로원 등 귀족세력의 강화를 바탕으로 해서 경제의 발전 및 학자의 배출 등 국가번영의 기운을 보였으나, 그 후  << _sbj_ >>  때 발트해의 주도권을 놓고 덴마크·스웨덴·폴란드·뤼벡 사이에 ‘북방 7년전쟁’이 일어났고,  << _obj_ >>  때는 2차에 걸친 스웨덴과의 싸움으로 국토의 손실과 국력의 쇠퇴를 가져왔다.
프레데리크_2세	크리스티안_4세	successor	  << _sbj_ >> 는 외할아버지,  << _obj_ >> 는 외숙부에 해당한다.
프레데리크_2세	크리스티안_4세	successor	 덴마크와 노르웨이의 왕  << _sbj_ >> 의 둘째 딸이며  << _obj_ >> 의 누나이다.
에게_해	그리스	country	레스보스는  << _obj_ >>  동부  << _sbj_ >> 에 있는 섬으로, 미틸리니 해협으로 터키와 떨어져 있다.
닌텐도	일본	country	  << _obj_ >> 의 게임 회사인  << _sbj_ >> 도 창립 초기에는 하나후다 제작 회사로 출발하였으며, 이후 하나후다 사업 규모는 줄어들었지만 현재에서도 하나후다 관련 카드들을 생산하고 있다.
루켄발데	독일	country	텔토프플레밍 군은  << _obj_ >>  브란덴부르크 주 남서부에 있는 군으로 다메슈프레발트 군, 엘베엘스터 군, 포츠담미텔마르크 군과 경계를 접하며 주도는  << _sbj_ >> 다.
살바도르_아옌데	아우구스토_피노체트	successor	방송 특성상 친 정부 성향의 논조를 띄는 경향이 크며, 그래서  << _sbj_ >>  정부와  << _obj_ >> 의 군사 독재 시절 TVN이 정부의 선전 미디어로 비판 받았다.
요아힘_뢰프	독일_축구_국가대표팀	team	최근  << _obj_ >>  감독  << _sbj_ >> 는, 그를 2011년 8월 10일의 브라질 축구 국가대표팀전을 위하여 처음으로 국가대표팀에 소집하였다.
장_발장	코제트	child	 마리우스의 요청으로 에포닌은  << _sbj_ >> 과  << _obj_ >> 가 사는 집의 위치를 알려줬다.
바부르	후마윤	child	 그는  << _sbj_ >> ,  << _obj_ >> , 악바르, 자한기르 의 뒤를 이은 5번째 무굴 황제이다.
바부르	후마윤	successor	 그는  << _sbj_ >> ,  << _obj_ >> , 악바르, 자한기르 의 뒤를 이은 5번째 무굴 황제이다.
후마윤	악바르	child	 그는 바부르,  << _sbj_ >> ,  << _obj_ >> , 자한기르 의 뒤를 이은 5번째 무굴 황제이다.
후마윤	악바르	successor	 그는 바부르,  << _sbj_ >> ,  << _obj_ >> , 자한기르 의 뒤를 이은 5번째 무굴 황제이다.
샤_자한	아우랑제브	child	아그라 성은 타지마할을 축조하면서 너무 많은 재정을 낭비한  << _sbj_ >> 이 말년에 그의 아들인  << _obj_ >> 에 의해 유폐된 곳으로도 유명한데 샤 자한은 야무나 강 너머의 타지마할이 가장 잘 보이는 무삼만 버즈에 갇혀 있다가 끝내 거기서 숨을 거두고 말았다.
샤_자한	아우랑제브	child	 종교적 융화책은 자항기르와  << _sbj_ >> 까지 이어지지만 6대  << _obj_ >> 가 다시 인두세를 부활시키는 등 종교적 억압책을 실시하면서 제국의 분열이 심화되기 시작했다.
샤_자한	아우랑제브	child	 종교적 융화책은 자항기르와  << _sbj_ >> 까지 이어지지만 6대  << _obj_ >> 가 다시 인두세를 부활시키는 등 종교적 억압책을 실시하면서 제국의 분열이 심화되기 시작했다.
샤_자한	아우랑제브	successor	아그라 성은 타지마할을 축조하면서 너무 많은 재정을 낭비한  << _sbj_ >> 이 말년에 그의 아들인  << _obj_ >> 에 의해 유폐된 곳으로도 유명한데 샤 자한은 야무나 강 너머의 타지마할이 가장 잘 보이는 무삼만 버즈에 갇혀 있다가 끝내 거기서 숨을 거두고 말았다.
샤_자한	아우랑제브	successor	 종교적 융화책은 자항기르와  << _sbj_ >> 까지 이어지지만 6대  << _obj_ >> 가 다시 인두세를 부활시키는 등 종교적 억압책을 실시하면서 제국의 분열이 심화되기 시작했다.
샤_자한	아우랑제브	successor	 종교적 융화책은 자항기르와  << _sbj_ >> 까지 이어지지만 6대  << _obj_ >> 가 다시 인두세를 부활시키는 등 종교적 억압책을 실시하면서 제국의 분열이 심화되기 시작했다.
페르남부쿠_주	브라질	country	알라고아스 주는  << _obj_ >> 의 북동부 대서양 연안에 위치하였으며 바이아 주, 세르지피 주,  << _sbj_ >> 와 이웃하고 있다.
마투그로수두술_주	브라질	country	파라나 주는  << _obj_ >>  남부 대서양 연안에 위치한 주로,  << _sbj_ >> , 상파울루 주, 산타카타리나 주과 이웃하고 있으며 아르헨티나, 파라과이와 국경을 접하고 있다.
태양은_없다	이정재_(배우)	starring	장동건 이후 9년 만에 배우  << _obj_ >> 가 1995년 영화 젊은 남자, 1999년 영화  << _sbj_ >> , 2013년 영화 관상 으로 신인남우상, 남우주연상, 남우조연상을 석권한 청룡의 두 번째 그랜드 슬래머에 올랐다.
자위대	일본	country	오가사와라 제도의 운송수단은  << _obj_ >>  본토에서 지치지마 섬 사이를 왕복하며, 오가사와라 제도에 있는  << _sbj_ >>  해병들을 위한 운송수단인 오가사와라마루 정기선뿐이다.
루이_3세	샤를로망	successor	 884년 서프랑크  << _sbj_ >> 와  << _obj_ >> 이 후사 없이 사망하고 새 왕을 선출할 때, 그의 집안 사람들이 샤를 3세 을 지지하지 않고 모두 외드를 지지하는 원인이 되었다.
최룡해	황병서	successor	2014년 10월, 인천 아시안게임의 폐막식에 조선민주주의인민공화국 노동당 비서  << _sbj_ >> , 총정치국장  << _obj_ >> , 노동당 비서 김양건 등이 참석을 통보하였고, 정부는 이를 수용하였다.
전준우	롯데_자이언츠	team	 2013년 4월 2일  << _obj_ >> 와의 1군 개막 경기에서 선발로 등판하여 팀의 사상 첫 번째 선발 투수가 되었고,  << _sbj_ >> 로부터 첫 번째 아웃 카운트를 잡았다.
이택근	넥센_히어로즈	team	1호 삼진투수 & 타자: SK 와이번스 김광현 &  << _obj_ >>   << _sbj_ >>
크리스_옥스프링	롯데_자이언츠	team	1호 헤드샷 퇴장:  << _obj_ >>   << _sbj_ >>  
눈물이_주룩주룩	도이_노부히로	director	 감독은 영화 《지금 만나러 갑니다 》, 《 << _sbj_ >> 》를 연출한  << _obj_ >> . 주연은 아라가키 유이, 이쿠타 토마.
칼리닌그라드	러시아	country	FC 발티카 칼리닌그라드는  << _obj_ >>   << _sbj_ >> 를 연고로 하는 축구 클럽으로 현재는 러시아 퍼스트 디비전에 참가하고 있다.
막심_리트비노프	뱌체슬라프_몰로토프	successor	5월 3일 : 소련 외무인민위원에  << _sbj_ >> 에서  << _obj_ >> 로 교체되었다.
손대음	고구려	country	백암성 성주  << _sbj_ >> 의 배신으로 당군에 포로로 잡혔지만 풀려났다는 점을 미루어 볼 때 이후  << _obj_ >> 군에 합류했을 가능성이 높다.
후야오방	자오쯔양	successor	 특히 덩샤오핑이 후계자로 정한  << _sbj_ >> 과  << _obj_ >> 이 연달아 실각한 것은 과도한 개혁 개방을 했기 때문으로 여긴 덩샤오핑이 보수파를 배려한 곳에서, 천윈의 존재감이 늘어갔다.
최만호	롯데_자이언츠	team	 그러나 2007년 팀 동료인  << _sbj_ >> 와 함께  << _obj_ >> 의 박석진과 손인호 를 상대로 트레이드되었고, 2008년 롯데 자이언츠에서도 방출되었다.
아는_여자	정재영	starring	 킬러들의 수다,  << _sbj_ >> , 웰컴 투 동막골로 호흡을 맞췄던 감독 장진 과 배우  << _obj_ >> 이 함께해 화제가 되었다.
에르빈_롬멜	나치_독일	country	 이탈리아가 끔찍한 역전을 당했을 때,  << _obj_ >> 의  << _sbj_ >>  원수 독일 아프리카 군단이 이탈리아군을 돕기 위해 파병되었다.
더_바이블	로마_다우니	starring	2014년 4월 25일 파라마운트 픽쳐스와 MGM은 2013년 미니시리즈  << _sbj_ >> 의 제작자 마크 버넷,  << _obj_ >> 와 같이 벤허를 공동 제작하겠다고 발표했다.
더_바이블	로마_다우니	director	2014년 4월 25일 파라마운트 픽쳐스와 MGM은 2013년 미니시리즈  << _sbj_ >> 의 제작자 마크 버넷,  << _obj_ >> 와 같이 벤허를 공동 제작하겠다고 발표했다.
호시우_광장	포르투갈	country	호시우 역은  << _obj_ >> 의 리스본 시내 중심가인  << _sbj_ >>  인근에 위치한 철도역이며, 신트라 선의 시발점이다.
호세_루이스_칠라베르트	파라과이_축구_국가대표팀	team	  << _obj_ >> 의 간판 골키퍼  << _sbj_ >> 가 출장 정지로 인해 첫 경기에 출장할 수 없었지만 파라과이 축구 국가대표팀는 16강에 진출하는 데 성공했고, 16강에서 독일 축구 국가대표팀을 만나 89분에 골을 허용해 탈락했다.
파올로_말디니	AC_밀란	team	체사레 말디니는 1954년부터 1966년까지  << _obj_ >> 에서 뛰었고, 아들  << _sbj_ >> 는 1985년부터 2009년까지 AC 밀란에서 뛰었으며, 손자 크리스티안 말디니가 2005년 10월 18일 AC 밀란 유스팀에 입단해 3부자가 모두 AC 밀란에서 활약하게 되었다.
더_보이스_(미국의_텔레비전_프로그램)	애덤_리바인	starring	 2014년 《 << _sbj_ >> 》 시즌 6에 참가해 마룬5의  << _obj_ >> 과 공연을 하는 등 어린나이에 놀라운 실력으로 이름을 알렸다.
슈타이어마르크_주	오스트리아	country	탈은  << _obj_ >>   << _sbj_ >> 의 도시로 면적은 18.57㎢, 높이는 440m, 인구는 2,276명, 인구 밀도는 120명/㎢이다.
마르코_판_바스턴	AC_밀란	team	 8강전에서  << _obj_ >> 은 SV 베르더 브레멘과 접전을 펼쳤고,  << _sbj_ >> 의 페널티킥 골로 인해 합계 1-0으로 4강에 진출했다.
에일라트	이스라엘	country	오브다 공항은  << _sbj_ >> 에 위치한  << _obj_ >> 의 국제공항으로 현재 오브다 공항은 3개의 국내선 노선과 3개의 국제선을 운항하고 있으며 계절편 국제선 노선도 운항하고 있다.
주오_구_(지바_시)	일본	country	하마노 역은  << _obj_ >>  지바 현 지바 시  << _sbj_ >> 에 있는 동일본 여객철도의 철도역이다.
자전거_탄_소년	다르덴_형제	director	《 << _sbj_ >> 》  << _obj_ >>
아리랑_(2011년_영화)	김기덕_(1960년)	starring	《 << _sbj_ >> 》  << _obj_ >>
아리랑_(2011년_영화)	김기덕_(1960년)	starring	《 << _sbj_ >> 》- 2011년  << _obj_ >>  감독의 장편영화
아리랑_(2011년_영화)	김기덕_(1960년)	starring	2011년  << _obj_ >>  감독의 《 << _sbj_ >> 》이 대상 수상.
아리랑_(2011년_영화)	김기덕_(1960년)	director	《 << _sbj_ >> 》  << _obj_ >>
아리랑_(2011년_영화)	김기덕_(1960년)	director	《 << _sbj_ >> 》- 2011년  << _obj_ >>  감독의 장편영화
아리랑_(2011년_영화)	김기덕_(1960년)	director	2011년  << _obj_ >>  감독의 《 << _sbj_ >> 》이 대상 수상.
기타이바라키_시	일본	country	오쓰코 역은  << _obj_ >>  이바라키 현  << _sbj_ >> 에 있는 동일본 여객철도의 철도역이다.
킹_군_(워싱턴_주)	미국	country	이사콰는  << _obj_ >>  워싱턴 주  << _sbj_ >> 의 도시로, 인구는 30,434명이다.
굿_셰퍼드	로버트_드_니로	starring	 레드메인은 이후  << _obj_ >>  감독의 영화 《 << _sbj_ >> 》로 헐리우드에 진출했고, 이어 《골든 에이지》, 《세비지 그레이스》, 《천일의 스캔들》, 《글로리어스 39》, 《파우더 블루》 그리고 《런어웨이 걸》에 출연하며 커리어를 쌓았다.
굿_셰퍼드	로버트_드_니로	starring	 2006년 홍콩 영화 《무간도》를 원작으로 한 《디파티드》에서 매사추세츠 주 경찰 콜린 설리번을 연기했으며, 마틴 스코세이지 감독 영화 《 << _sbj_ >> 》에서 CIA 직원 에드워드 윌슨을 연기하여  << _obj_ >> 와 호흡을 맞추었다.
굿_셰퍼드	로버트_드_니로	starring	 다음 영화로  << _obj_ >>  감독의 《 << _sbj_ >> 》에 출연했다.
굿_셰퍼드	로버트_드_니로	director	 레드메인은 이후  << _obj_ >>  감독의 영화 《 << _sbj_ >> 》로 헐리우드에 진출했고, 이어 《골든 에이지》, 《세비지 그레이스》, 《천일의 스캔들》, 《글로리어스 39》, 《파우더 블루》 그리고 《런어웨이 걸》에 출연하며 커리어를 쌓았다.
굿_셰퍼드	로버트_드_니로	director	 2006년 홍콩 영화 《무간도》를 원작으로 한 《디파티드》에서 매사추세츠 주 경찰 콜린 설리번을 연기했으며, 마틴 스코세이지 감독 영화 《 << _sbj_ >> 》에서 CIA 직원 에드워드 윌슨을 연기하여  << _obj_ >> 와 호흡을 맞추었다.
굿_셰퍼드	로버트_드_니로	director	 다음 영화로  << _obj_ >>  감독의 《 << _sbj_ >> 》에 출연했다.
주피터_어센딩	라나_워쇼스키	director	레드메인은 2015년  << _obj_ >> , 앤디 워쇼스키 감독의 SF 액션 블록버스터 영화 《 << _sbj_ >> 》에서 우주에서 가장 부유하고 강력한 아브라삭스 가문의 후계자 발렘 아브라삭스 역을 맡아 데뷔 이후 첫 악역 연기를 선보였다.
화씨_9/11	마이클_무어	starring	 황금종려상은  << _obj_ >>  감독의 미국 영화 《 << _sbj_ >> 》이 수상하였다.
화씨_9/11	마이클_무어	starring	《 << _sbj_ >> 》  << _obj_ >>
화씨_9/11	마이클_무어	starring	 《벤저민 브리튼을 추모하는 성가》는  << _obj_ >> 의  << _sbj_ >>  중에서 테러 직후의 장면에서 배경음악으로 쓰였다.
화씨_9/11	마이클_무어	director	 황금종려상은  << _obj_ >>  감독의 미국 영화 《 << _sbj_ >> 》이 수상하였다.
화씨_9/11	마이클_무어	director	《 << _sbj_ >> 》  << _obj_ >>
화씨_9/11	마이클_무어	director	 《벤저민 브리튼을 추모하는 성가》는  << _obj_ >> 의  << _sbj_ >>  중에서 테러 직후의 장면에서 배경음악으로 쓰였다.
슈렉_2	켈리_애스버리	director	《 << _sbj_ >> 》 앤드루 애덤슨,  << _obj_ >> , 콘래드 버논
포드고리차	몬테네그로	country	 2006년 세르비아와  << _obj_ >> 가 갈라진 후 출생지인  << _sbj_ >> 가 속해있는 몬테네그로의 몬테네그로 축구 국가대표팀을 선택하였다.
브라방왈롱_주	벨기에	country	워털루는  << _obj_ >>   << _sbj_ >> 에 있는 왈롱의 행정 구역으로 2011년 현재 인구는 29,706명이다.
매디슨_범가너	샌프란시스코_자이언츠	team	 2014년에는 좋은 수비와 더불어 2년 전보다 2리 더 오른 .366의 타율을 기록하며, 헌터 펜스,  << _sbj_ >> 와 함께  << _obj_ >> 의 우승을 견인했다.
최동원	롯데_자이언츠	team	1980년대에 있었던 한국프로야구선수협회 사건으로 인해 1988년 한국 프로 야구 11월 23일 전용권, 오대석, 허규옥과 함께  << _sbj_ >> , 김성현 , 오명록을 상대로  << _obj_ >> 에 트레이드되었다.
우주_전쟁_(2005년_영화)	스티븐_스필버그	director	《 << _sbj_ >> 》은  << _obj_ >> 가 감독을 맡아 2005년에 제작한 영화이다.
크리스티안스타드	스웨덴	country	크리스티안스타드 주는 과거  << _obj_ >> 에 존재했던 주로 주도는  << _sbj_ >> 였으며 1719년부터 1996년 12월 31일까지 존재했다.
심야병원	유연석	starring	 한편 송중기가 연기하는 늑대소년 "철수"와는 적대 역할인 "지태"는 드라마 《 << _sbj_ >> 》, 영화 《건축학개론》에 출연한  << _obj_ >> 이 캐스팅되었다.
AFC_챔피언스리그_2010	성남_FC	team	 이후 소속팀으로 복귀하여  << _sbj_ >> 에서 결승까지 4골을 기록하며 팀이 결승에 오르는데 기여하였으며, 결승전에서도 득점을 기록하였으나  << _obj_ >> 에 3-1로 패하여 우승은 좌절되었다.
악비	남송	country	 이때 당시 청나라의 군사 상당수는 개국 때 혁혁한 공을 세운 팔기군이 아닌 강희제 때 신설된 한족 출신의 군대 녹영의 군사들로서  << _obj_ >> 의 명장  << _sbj_ >> 의 후손인 사천총독 악종기와 만주족 출신의 장수 아계 가 주지휘관으로 활약하였다.
그랜드포크스	미국	country	노스다코타 대학교는  << _obj_ >>  노스다코타 주  << _sbj_ >> 에 위치한 공립 대학교이다.
도치기_현	일본	country	우에노 료는  << _obj_ >>   << _sbj_ >>  출신의 배우이다.
해부루왕	금와왕	child	  << _sbj_ >> 이 늙도록 자식이 없다가 곤연 돌 밑에서 금색 개구리 모양의 아기를 주워 아들로 삼았는데, 커서  << _obj_ >> 이 되었다.
해부루왕	금와왕	child	  << _sbj_ >> 의 아들이  << _obj_ >> 이므로 고주몽은 해부루왕의 손자뻘이기 때문이다.
해부루왕	금와왕	successor	  << _sbj_ >> 이 늙도록 자식이 없다가 곤연 돌 밑에서 금색 개구리 모양의 아기를 주워 아들로 삼았는데, 커서  << _obj_ >> 이 되었다.
해부루왕	금와왕	successor	  << _sbj_ >> 의 아들이  << _obj_ >> 이므로 고주몽은 해부루왕의 손자뻘이기 때문이다.
황해	조선민주주의인민공화국	country	대한민국은 동해를 사이에 두고 일본 열도와,  << _sbj_ >> 를 사이에 두고 중화인민공화국과 마주하며, 육지로는 한반도의 군사 분계선을 사이에 두고  << _obj_ >> 과 맞닿아 있다.
아시카가_요시아키라	아시카가_요시미쓰	child	 제1대 아시카가 다카우지 ┬ 제2대  << _sbj_ >>  ─ 제3대  << _obj_ >>  ┬ 제4대 아시카가 요시모치 ─ 제5대 아시카가 요시카즈
아시카가_요시아키라	아시카가_요시미쓰	child	쇼군 : 무로마치 막부의  << _sbj_ >> ,  << _obj_ >>
아시카가_요시아키라	아시카가_요시미쓰	child	쇼군 : 무로마치 막부의 아시카가 다카우지,  << _sbj_ >> ,  << _obj_ >>
아시카가_요시아키라	아시카가_요시미쓰	child	막부는 2대 쇼군  << _sbj_ >> 의 대에 시바 우지쓰네 ・ 시부카와 요시유키를 규슈 단다이로 임명하였으나 규슈 제압은 진전이 없었고, 조지 6년/쇼헤이 22년에는 아직 어렸던 3대 쇼군  << _obj_ >> 를 보좌하고 있던 간레이 호소카와 요리유키가 이마가와 사다요을 규슈 단다이로 임명해 파견하였다.
아시카가_요시아키라	아시카가_요시미쓰	successor	 제1대 아시카가 다카우지 ┬ 제2대  << _sbj_ >>  ─ 제3대  << _obj_ >>  ┬ 제4대 아시카가 요시모치 ─ 제5대 아시카가 요시카즈
아시카가_요시아키라	아시카가_요시미쓰	successor	쇼군 : 무로마치 막부의  << _sbj_ >> ,  << _obj_ >>
아시카가_요시아키라	아시카가_요시미쓰	successor	쇼군 : 무로마치 막부의 아시카가 다카우지,  << _sbj_ >> ,  << _obj_ >>
아시카가_요시아키라	아시카가_요시미쓰	successor	막부는 2대 쇼군  << _sbj_ >> 의 대에 시바 우지쓰네 ・ 시부카와 요시유키를 규슈 단다이로 임명하였으나 규슈 제압은 진전이 없었고, 조지 6년/쇼헤이 22년에는 아직 어렸던 3대 쇼군  << _obj_ >> 를 보좌하고 있던 간레이 호소카와 요리유키가 이마가와 사다요을 규슈 단다이로 임명해 파견하였다.
아시카가_요시미쓰	아시카가_요시모치	child	 제1대 아시카가 다카우지 ┬ 제2대 아시카가 요시아키라 ─ 제3대  << _sbj_ >>  ┬ 제4대  << _obj_ >>  ─ 제5대 아시카가 요시카즈
아시카가_요시미쓰	아시카가_요시모치	child	아시카가 요시노리는 일본 무로마치 시대 중기에 재임한 무로마치 막부 제 6대 쇼군이다. 제 3대 쇼군  << _sbj_ >> 의 삼남으로, 모친은 요시미쓰의 측실 후지와라 요시코로, 제 4대 쇼군  << _obj_ >> 의 동복 동생이다.
아시카가_요시미쓰	아시카가_요시모치	child	쇼군 : 무로마치 막부의  << _sbj_ >> ,  << _obj_ >> , 아시카가 요시카즈
아시카가_요시미쓰	아시카가_요시모치	successor	 제1대 아시카가 다카우지 ┬ 제2대 아시카가 요시아키라 ─ 제3대  << _sbj_ >>  ┬ 제4대  << _obj_ >>  ─ 제5대 아시카가 요시카즈
아시카가_요시미쓰	아시카가_요시모치	successor	아시카가 요시노리는 일본 무로마치 시대 중기에 재임한 무로마치 막부 제 6대 쇼군이다. 제 3대 쇼군  << _sbj_ >> 의 삼남으로, 모친은 요시미쓰의 측실 후지와라 요시코로, 제 4대 쇼군  << _obj_ >> 의 동복 동생이다.
아시카가_요시미쓰	아시카가_요시모치	successor	쇼군 : 무로마치 막부의  << _sbj_ >> ,  << _obj_ >> , 아시카가 요시카즈
아시카가_요시미쓰	아시카가_요시노리	child	 무로마치 시대의 통치자였던  << _sbj_ >> 의 후원 속에서 왕성한 활동을 하였으나 요시미쓰의 사후 그의 아들인  << _obj_ >> 로 정권이 바뀌자 사도 섬으로 귀양을 가는 등 만년에는 비극적인 운명을 살다가 귀양지에서 사망하였다.
대한민국_공군사관학교	대한민국	country	5년제 정규 과정의 학생들은 졸업후 공군 소위로 임관하여 초급 지휘관으로 임용되므로,  << _obj_ >> 의  << _sbj_ >> 와 기능상 유사하다.
고하토	오시마_나기사	director	《 << _sbj_ >> 》  << _obj_ >>
코치_(헝가리)	헝가리	country	 "코치"라는 말은  << _obj_ >> 의  << _sbj_ >> 라는 마을에서 만들어진 사륜 마차 코치 에서 유래하였다.
2003_UEFA_챔피언스리그_결승전	AC_밀란	team	 세리에 A 2002-03, 그는 유벤투스의  << _sbj_ >> 행의 주역이었는데 이 결승전에서 유벤투스는  << _obj_ >> 에게 승부차기 끝에 패하였다.
케빈_키건	잉글랜드_축구_국가대표팀	team	 이후 1982년 아서 콕스가 감독을 맡아  << _obj_ >>  주장이었던  << _sbj_ >> 을 영입하는 등 돌풍을 일으키며 1부 리그로 승격시켰다.
정_때문에	정혜선	starring	김명직 역의 남성훈은 <행복은 우리 가슴에>를 조기종영시키게 한 드라마 중의 하나인 KBS 1TV  << _sbj_ >>  출연진이었던  << _obj_ >> 과 함께 SBS 이웃집 여자에서 공연했었는데 이 작품 후반부 때 경쟁한 KBS 2TV 아씨 에서 아씨의 시할머니 역으로 나온 배우는 <행복은 우리 가슴에>, 정 때문에와 같은 시간대에 경쟁한 MBC 세 번째 남자 출연진에 속했던 여운계였다.
열애_(1997년_드라마)	성현아	starring	이 때문에 이민영 은 KBS 2TV  << _sbj_ >>  캐스팅 제의를 받았으나 고사했고 당시 이민영  자리에는  << _obj_ >> 가 대타로 들어갔다.
가면_속의_천사	강석우	starring	우광남 역의 연규진, 장모란 역의 이혜숙과 담당 PD 한정희씨가 호흡을 맞춘 드라마 중의 하나인 KBS 2TV 좋은 남자 좋은 여자 여주인공이었던 염정아는 이 작품의 뒷시간대 드라마이자 1995년 5월 10일부터 6월 29일까지 방영된 자사 수목 미니시리즈 창공 에 출연해 왔었으며 나판수 역의  << _obj_ >> 는 창공  후속작인  << _sbj_ >>  출연진이었다.
치와와_주	멕시코	country	크리스탈 동굴 은  << _obj_ >>   << _sbj_ >> 의 나이카 광산 지하 300m에 위치한 동굴이다.
데번_주	영국	country	엑스머스는  << _obj_ >>   << _sbj_ >> 의 도시로, 인구는 2011년 조사 기준 34,432명이다.
우스터셔_주	영국	country	레디치는  << _obj_ >>   << _sbj_ >> 의 도시로, 인구는 2011년 조사 기준 84,300명이다.
맨발의_청춘_(1998년_드라마)	배용준	starring	결국  << _obj_ >> 이 최지우의 상대역으로 낙점되는 듯 했지만 KBS 2TV 월화극  << _sbj_ >> 을 막 끝낸 뒤라 당분간 휴식시간을 갖겠다면서 출연을 고사했으며 뒷날 정준호가 창우 역으로 캐스팅됐으나 이 과정에서 MBC 측과 한때 마찰을 겪은 데 이어 수미 역의 최지우는 일주일 내내 촬영스케줄이 빡빡하고 하루도 시간을 낼 수 없다는 이유로 출연을 포기했다.
백령도	대한민국	country	 현재  << _obj_ >> 의 인천광역시 옹진군 에서 관할하고 있는  << _sbj_ >> ·대청도·소청도는 광복 당시 황해도 장연군 백령면에, 연평도는 벽성군 송림면에 속했었다.
고려_태조	고려_혜종	child	본래 신분이 낮은 나주 호족의 딸이었으나,  << _sbj_ >> 를 만나  << _obj_ >> 을 낳고, 대광인 박술희 등의 비호를 받았다.
고려_태조	고려_혜종	child	 943년  << _sbj_ >> 가 승하하고  << _obj_ >> 이 즉위한 후 신라 수도였던 동경 대도독으로 부임하였다.
고려_태조	고려_혜종	child	 그 뒤 희양산 봉암사에서 선실을 일으키고  << _sbj_ >>  << _obj_ >> 고려 정종 고려 광종 등 역대 왕의 존신을 받았다.
고려_태조	고려_혜종	successor	본래 신분이 낮은 나주 호족의 딸이었으나,  << _sbj_ >> 를 만나  << _obj_ >> 을 낳고, 대광인 박술희 등의 비호를 받았다.
고려_태조	고려_혜종	successor	 943년  << _sbj_ >> 가 승하하고  << _obj_ >> 이 즉위한 후 신라 수도였던 동경 대도독으로 부임하였다.
고려_태조	고려_혜종	successor	 그 뒤 희양산 봉암사에서 선실을 일으키고  << _sbj_ >>  << _obj_ >> 고려 정종 고려 광종 등 역대 왕의 존신을 받았다.
조지_1세	조지_2세	child	 1727년,  << _sbj_ >> 가 죽고  << _obj_ >> 가 즉위하면서 새 의회가 소집된다.
조지_1세	조지_2세	child	  << _sbj_ >> ,  << _obj_ >>  세대에 도시와 시골에서 널리 행해지게 되었다.
조지_1세	조지_2세	successor	 1727년,  << _sbj_ >> 가 죽고  << _obj_ >> 가 즉위하면서 새 의회가 소집된다.
조지_1세	조지_2세	successor	  << _sbj_ >> ,  << _obj_ >>  세대에 도시와 시골에서 널리 행해지게 되었다.
어머님_생전에	이혁수	director	1973년  << _sbj_ >>  :  << _obj_ >>  감독
기이_반도	일본	country	 베라는 9월 23일부터 9월 26일까지 사피어-심프슨 허리케인 등급 제5등급의 세력을 계속해서 유지해 거의 태풍의 최성기에 맞먹는 세력으로 9월 26일  << _obj_ >>   << _sbj_ >>  남부의 와카야마 현 시오노미 곶에 상륙하게 된다.
붉은_다리_아래_따뜻한_물	이마무라_쇼헤이	director	《 << _sbj_ >> 》  << _obj_ >>
비기너즈!	후지가야_다이스케	starring	〈WANNA BEEEE!!!〉는 멤버  << _obj_ >> , 기타야마 히로미쓰가 출연하는 드라마 《 << _sbj_ >> 》의 주제가. 〈Shake It Up〉은 멤버 미야타 도시야가 출연한 《사립 바카레아 고교》의 OP곡. 커플링곡 〈Summer Lover〉는 자신이 출연하고 있는 후지 TV 계열 《모시모 투어즈》 테마 송으로 기용되었다.
스파이더맨_3	브라이스_댈러스_하워드	starring	 《 << _sbj_ >> 》에서는  << _obj_ >> 가, 《어메이징 스파이더맨 》에서는 엠마 스톤이 역할을 맡았다.
다크_나이트_라이즈	톰_하디	starring	 배트맨 영화판인 《배트맨과 로빈》에서는 로버트 스웬슨이, 《 << _sbj_ >> 》에서는  << _obj_ >> 가 맡았다.
사보나_현	이탈리아	country	리알토는  << _obj_ >>  리구리아 주  << _sbj_ >> 에 위치한 도시로, 인구는 570명이다.
파비오_카펠로	AC_밀란	team	  << _sbj_ >> 의  << _obj_ >> 은 조지 웨아와 로베르토 바조를 영입한다.
마르코_델베키오	AS_로마	team	  << _obj_ >> 는 인테르의  << _sbj_ >> 와 US 포자의 루이지 디 비아조를 영입했다.
지네딘_지단	FC_지롱댕_드_보르도	team	  << _obj_ >> 에서  << _sbj_ >> 을 영입한 유벤투스 FC는 아탈란타 BC에서 파올로 몬테로를 영입하고, 크리스티안 비에리와 니콜라 아모루소와 같은 젊은 선수를 데려온다.
후안_세바스티안_베론	UC_삼프도리아	team	  << _obj_ >> 는 보카 주니어스에서 미드필더  << _sbj_ >> 을, 제노아 CFC에서 공격수 빈첸초 몬텔라를 영입한다.
방울토마토_(영화)	정영배	director	2008년에는 그녀가 조연으로 출연한  << _obj_ >>  감독의 《 << _sbj_ >> 》와 《잘못된 만남》이 개봉하였다.
유르말라	라트비아	country	토르냐칼른스-투쿰스 II 선은  << _obj_ >> 의 철도 노선으로,  << _sbj_ >> 를 경유하여 리가와 투쿰스를 잇는 노선이다.
하우다	네덜란드	country	 미국이나 영국에서 생산되는 슬라이스 치즈가 있으며,  << _obj_ >> 의  << _sbj_ >> 는 구멍이 없고 동그랗고 납작한 모양이고, 프랑스의 치즈는 작게 잘려 있다.
김성기_(1961년)	강경상업고등학교	team	 둘의 장인  << _sbj_ >>  또한 축구 선수 출신으로 현재  << _obj_ >>  축구부 감독을 맡고 있다.
에식스_주	영국	country	런던 지하철은  << _obj_ >>  그레이터 런던과  << _sbj_ >> , 하트퍼드셔 주, 그리고 버킹엄셔 주 등의 주변 지역에서 운영되고 있는 지하철도망이다.
렌_(도시)	프랑스	country	브르타뉴는  << _obj_ >>  북서부에 위치한 프랑스의 레지옹으로 중심 도시는  << _sbj_ >> 이며 면적은 27,208㎢, 인구는 3,237,097명이다.
마크_가솔	멤피스_그리즐리스	team	 동생은  << _obj_ >> 의 센터  << _sbj_ >> 이다.
카푸	AS_로마	team	 전SS 라치오 감독이었던 즈데넥 제만이 이끄는  << _obj_ >> 는  << _sbj_ >> , 뱅상 캉델라와 안토니우 카를로스 자구의 영입으로 더욱 강해졌다.
인디라_간디	라지브_간디	child	 인도 초대 수상이였던 증조 할아버지 자와할랄 네루, 인도 최초 여성 수상이 된 할머니  << _sbj_ >> , 아버지  << _obj_ >>  그리고 현재 인도 국민 회의의 의장을 맡고 있는 어머니 소냐 간디의 힘을 받아 정치계에 입문하였다.
인디라_간디	라지브_간디	child	 1967년에는 네루의 딸  << _sbj_ >> 가 의회의 지지를 받아 총리로 취임했고 인디라 간디가 암살된 이듬해 아들인  << _obj_ >> 가 총리에 취임했다.
인디라_간디	라지브_간디	child	 1965년 영국 케임브리지 대학교 유학 시절에 당시 인도 총리인  << _sbj_ >> 의 장남  << _obj_ >> 와 만나 1968년에 결혼하였다.
인디라_간디	라지브_간디	child	 1984년 10월 31일 시어머니인  << _sbj_ >>  총리가 시크교도 경호원에게 암살되고, 1991년 총선 유세 중이던 남편  << _obj_ >> 가 시크교도가 설치한 폭탄 테러로 목숨을 잃자, 소냐 간디는 극도의 정치 혐오증을 보이면서 은둔 생활을 하였다.
인디라_간디	라지브_간디	successor	 인도 초대 수상이였던 증조 할아버지 자와할랄 네루, 인도 최초 여성 수상이 된 할머니  << _sbj_ >> , 아버지  << _obj_ >>  그리고 현재 인도 국민 회의의 의장을 맡고 있는 어머니 소냐 간디의 힘을 받아 정치계에 입문하였다.
인디라_간디	라지브_간디	successor	 1967년에는 네루의 딸  << _sbj_ >> 가 의회의 지지를 받아 총리로 취임했고 인디라 간디가 암살된 이듬해 아들인  << _obj_ >> 가 총리에 취임했다.
인디라_간디	라지브_간디	successor	 1965년 영국 케임브리지 대학교 유학 시절에 당시 인도 총리인  << _sbj_ >> 의 장남  << _obj_ >> 와 만나 1968년에 결혼하였다.
인디라_간디	라지브_간디	successor	 1984년 10월 31일 시어머니인  << _sbj_ >>  총리가 시크교도 경호원에게 암살되고, 1991년 총선 유세 중이던 남편  << _obj_ >> 가 시크교도가 설치한 폭탄 테러로 목숨을 잃자, 소냐 간디는 극도의 정치 혐오증을 보이면서 은둔 생활을 하였다.
이탈리안_잡_(1969년_영화)	피터_콜린슨	director	 트로이 케네디 마틴이 쓰고  << _obj_ >>  감독이 연출한 1969년  << _sbj_ >> 를 리메이크한 작품이다.
이들리브_주	시리아	country	이들리브 순교자 여단은  << _obj_ >>   << _sbj_ >>  지역의 반정부 군사 조직이다.
케빈에_대하여	존_C._라일리	starring	 다음에는 린 램지가 미국 작가 라이오넬 슈라이버의 2003년 동명 소설을 각색하여 감독한 BBC 필름 영화 《 << _sbj_ >> 》에서  << _obj_ >> 와 틸다 스윈턴과 함께 케빈 역으로 출연하였다.
프란시스코_프랑코	스페인_제2공화국	country	 1934년에는  << _obj_ >> 으로부터 훈장을 수여받았고, 스페인 내전 동안에는  << _sbj_ >> 파 선전원들로부터 그들을 위해 경기를 뛰라고 강요를 받았으며, 1950년대에는 프란시스코 프랑코로부터 훈장을 수여받았다.
킹메이커_(영화)	조지_클루니	starring	 영화제는  << _obj_ >>  감독의 미국 영화 《 << _sbj_ >> 》 로 개막되었다.
킹메이커_(영화)	조지_클루니	director	 영화제는  << _obj_ >>  감독의 미국 영화 《 << _sbj_ >> 》 로 개막되었다.
자토이치_(2003년_영화)	키타노_타케시	starring	2003년  << _obj_ >>  《 << _sbj_ >> 》
자토이치_(2003년_영화)	키타노_타케시	director	2003년  << _obj_ >>  《 << _sbj_ >> 》
클랜_(영화)	파블로_트라페로	director	2015년  << _obj_ >>  《 << _sbj_ >> 》
내셔널_하키_리그	몬트리올_커네이디언스	team	디트로이트 레드윙스는 미시간 주 디트로이트를 연고지로 하는  << _sbj_ >> 의 동부 콘퍼런스  애틀랜틱 디비전  소속 아이스 하키팀이며, 토론토 메이플리프스,  << _obj_ >> , 뉴욕 레인저스, 보스턴 브루인스, 시카고 블랙호크스와 더불어 NHL의 오리지널 식스 팀 가운데 하나이기도 하다.
캐롤_(영화)	토드_헤인스	director	그 외 알려진 작품으로는 스파이크 존즈 감독의 《존 말코비치 되기》 , 《어댑테이션》 , 《괴물들이 사는 나라 》 , 데이비드 O. 러셀 감독의 《쓰리 킹즈》 , 드라마 《올리브 키터리지》 , 《아노말리사》 ,  << _obj_ >>  감독의 《벨벳 골드마인》 , 드라마 《밀드레드 피어스》, 《 << _sbj_ >> 》  등이 있다.
존_말코비치_되기	스파이크_존즈	director	그 외 알려진 작품으로는  << _obj_ >>  감독의 《 << _sbj_ >> 》 , 《어댑테이션》 , 《괴물들이 사는 나라 》 , 데이비드 O. 러셀 감독의 《쓰리 킹즈》 , 드라마 《올리브 키터리지》 , 《아노말리사》 , 토드 헤인스 감독의 《벨벳 골드마인》 , 드라마 《밀드레드 피어스》, 《캐롤 》  등이 있다.
드림웍스	미국	country	 2008년  << _obj_ >> 의  << _sbj_ >> 가 리메이크 판의 제작을 발표했다.
과나후아토_주	멕시코	country	과나후아토는  << _obj_ >>   << _sbj_ >> 의 주도로, 인구는 153,364명이다.
이영진_(1963년)	FC_서울	team	 갑작스레 공석이 된 감독 자리를 메우기 위해 공개 감독 공모를 하게 된 결과 27명의 응모자 중 K리그 2009까지  << _obj_ >> 의 수석 코치를 역임했던  << _sbj_ >> 이 2009년 12월 22일 자로 대구 FC의 제 3대 신임 감독으로 선임되었다.
아메리칸_허슬	크리스천_베일	starring	같은 해, 아담스는  << _obj_ >> , 브래들리 쿠퍼와 제니퍼 로렌스와 출연한 데이비드 O. 러셀 감독의 영화 《 << _sbj_ >> 》에 캐스팅 되었다.
과비아레_주	콜롬비아	country	산호세델과비아레는  << _obj_ >>   << _sbj_ >> 의 주도이다.
인리다	콜롬비아	country	과이니아 주는  << _obj_ >>  동부에 위치한 주로 주도는  << _sbj_ >> 이며 면적은 72,238㎢, 인구는 40,203명, 인구 밀도는 0.56명/㎢이다.
세사르_주	콜롬비아	country	바예두파르는  << _obj_ >>   << _sbj_ >> 의 주도로, 인구는 354,180명이다.
요팔	콜롬비아	country	카사나레 주는  << _obj_ >>  동부에 위치한 주로 주도는  << _sbj_ >> 이며 면적은 44,640㎢, 인구는 344,027명, 인구 밀도는 7.7명/㎢이다.
뱅고어_(웨일스)	웨일스	country	뱅고어 대학교는  << _obj_ >>   << _sbj_ >> 에 위치한 대학교이다.
두_개의_문	김일란	director	 2009년 1월 20일에 발생한 용산4구역 남일당 화재 사건을 다룬 《 << _sbj_ >> 》을  << _obj_ >> 과 함께 연출하였다.
우리의_환대	버스터_키튼	starring	  << _obj_ >> 이 출연한 영화에서 주로 악당 역할로 나왔으며 《 << _sbj_ >> 》를 찍고 뇌졸중으로 사망하였다.
우리의_환대	버스터_키튼	director	  << _obj_ >> 이 출연한 영화에서 주로 악당 역할로 나왔으며 《 << _sbj_ >> 》를 찍고 뇌졸중으로 사망하였다.
미에_현	일본	country	 1939년 조선산업주식회사 대주주로 참여했고, 같은 해 4월 21일부터 5월 2일까지 충청남도 도회의원 신궁참배단의 일원으로  << _obj_ >>   << _sbj_ >>  이세 신궁, 도쿄 메이지 신궁, 나고야 시 아쓰타 신궁, 나라 현 가시하라 신궁 등을 참배했다.
맥도넬더글러스_DC-10	맥도넬더글러스_MD-11	successor	 그러나 3발기인  << _sbj_ >> 이나  << _obj_ >> , 보잉 727, 투폴레프 Tu-154 또는 4발 제트엔진 항공기인 에어버스 A380, 에어버스 A340, 보잉 747, 보잉 707, 더글러스 DC-8, 전 세계적으로 보기가 매우 드문 1대생산된 6발 엔진 장착 항공기인 안토노프 An-225 등 쌍발기 이외의 다른 항공기들은 ETOPS 규제가 적용되지 않는다.
언_애듀케이션	로네_시에비	director	그녀의 인생에 있어 전환점이 된 22살에, 그녀는 덴마크 감독  << _obj_ >> 이 감독을 맡고 닉 혼비가 각본을 쓴 2009년의 독립 영화 《 << _sbj_ >> 》에서 주연인 제니에 캐스팅되었다.
하갈	이스마엘	child	이삭이 자라 젖을 땐 후, 사라는  << _obj_ >> 이 이삭을 놀리는 것을 보고 아브라함에게 이스마엘과 그의 어머니인 여종  << _sbj_ >> 을 내쫓으라고 요구했는데, 그래야 비로소 이삭이 아브라함의 유일한 상속자가 될 수 있었다.
보잉_747	보잉_747-400	successor	한 때  << _sbj_ >> ,  << _obj_ >> 를 114대 보유한 747기의 최대 소유주 였으나 구조 조정의 일환으로 2011년에 전량 퇴역 되었다.
둥비우	쑹칭링	successor	 이후 국가주석직은 일시적으로 공석이 되었고, 부주석  << _sbj_ >> 와  << _obj_ >> 을 주석대행에 앉힌 뒤 사실상의 주석직 복귀와 다를 바 없는 실권을 행사한다.
백_투_더_퓨처	로버트_저메키스	director	제17회  영화 《 << _sbj_ >> 》  << _obj_ >>
이유있는_반항_(2009년_영화)	미겔_아르테타	director	2009년에 개봉한  << _obj_ >> 의 코미디 드라마 영화인 《 << _sbj_ >> 》에서 대학교를 가기 전 50명의 남자와 잠을 자려하는 태거티 역을 연기하였다.
발드마른_주	프랑스	country	생망데는  << _obj_ >>   << _sbj_ >> 의 도시로, 인구는 22,946명이다.
슬리핑_위드_아더_피플	레슬리_헤드랜드	director	 2015년에 그녀는 제이슨 서데이키스와 함께  << _obj_ >> 의 로맨틱 코미디 영화 《 << _sbj_ >> 》에 출연했고, 《겟 하드》에서 윌 페럴의 극중 약혼자 역을 연기했다.
바람계곡의_나우시카_(영화)	미야자키_하야오	director	 1984년에 14살의 나이로 일본의 애니메이션 감독인  << _obj_ >> 의 장편 애니메이션인 《 << _sbj_ >> 》에 성우로 출연하여 크샤나 역을 맡으면서 연기자로서의 첫 경력을 시작한다.
퓌드돔_주	프랑스	country	보몽은  << _obj_ >>   << _sbj_ >> 의 도시로, 인구는 11,214명이다.
렛츠_비_캅스	제이크_존슨	starring	2014년 8월 영화 《 << _sbj_ >> 》에서  << _obj_ >> , 데이먼 웨이언스 주니어과 호흡을 맞췄다.
사랑에_대한_모든_것	에디_레드메인	starring	존스는 그녀의 현재 연기 경력에서 정점이 된 로맨스 전기 영화 《 << _sbj_ >> 》에서 제인 와일드 호킹 역할을 연기했고, 세계적으로 유명한 물리학자 스티븐 호킹의 인생과 사랑을 담은 이 영화에서 호킹을 연기한  << _obj_ >> 과 공연했다.
분노의_질주	빈_디젤	starring	2001년 워커는 《 << _sbj_ >> 》 에  << _obj_ >> 과 대립하는 FBI 경찰 브라이언 오코너 역으로 출연하였다.
스위트_크리스마스	페넬로페_크루스	starring	 2004년에는 크리스마스를 배경으로 한 영화 《 << _sbj_ >> 》에서 마이크 라일리 역을 맡아  << _obj_ >> 와 호흡을 맞추었다.
블루_스톰	제시카_알바	starring	 2005년에는 《 << _sbj_ >> 》에서 재러드 역을 맡아  << _obj_ >> 와도 호흡을 맞추었다.
시몬_(2002년_영화)	알_파치노	starring	 같은 해,  << _obj_ >>  주연 영화 《 << _sbj_ >> 》에서 조연으로 출연했다.
찰리_컨트리맨	루퍼트_그린트	starring	2013년 영화 《 << _sbj_ >> 》에 출연해 샤이아 라보프,  << _obj_ >> 와 호흡을 맞췄다.
랑팡_시	중화인민공화국	country	베이징 수도 제2공항 또는 베이징 다싱 국제공항은 2019년 9월 개항을 목표로  << _obj_ >>  베이징 시 가장 남쪽의 다싱 구와 허베이 성  << _sbj_ >>  광양 구의 경계지에 건설 중인 국제공항이다.
디_아더_가이스	애덤_매케이	director	  << _obj_ >>  감독의 영화 《앵커맨 》, 《 << _sbj_ >> 》 등의 코미디 영화에서 각본과 주연을 담당했다.
누마즈_시	일본	country	오오카 역은  << _obj_ >>  시즈오카 현  << _sbj_ >> 에 있는 도카이 여객철도 고텐바 선의 철도역이다.
쿠로사기_(영화)	야마시타_토모히사	starring	또,  << _obj_ >>  주연 영화 《 << _sbj_ >> 》 주제가로도 사용되고 있다.
보리밭을_흔드는_바람	켄_로치	director	2006년, 그는  << _obj_ >> 가 감독한 아일랜드 독립전쟁과 내전에 관한 영화, 2006 Cannes Film Festival에서 황금종려상을 받고 아일랜드 박스오피스에서 가장 흥행한 아일랜드 독립영화인 《 << _sbj_ >> 》의 주연을 맡았다.
다이애나_(영화)	나오미_왓츠	starring	 채스테인은 또한 전기 영화 《 << _sbj_ >> 》에 다이애나 왕세자비 역을 제안받았으나, 거기에서 하차하고  << _obj_ >> 로 대체되었다.
인터스텔라	앤_해서웨이	starring	 채스테인은 매튜 매커니히와  << _obj_ >> 와 함께 크리스토퍼 놀런이 감독을 맡은 《 << _sbj_ >> 》에 출연하였다.
에르난_크레스포	리버_플레이트	team	 이후  << _sbj_ >> 의 대체자를 찾던 아르헨티나의 명문 클럽  << _obj_ >> 로 이적하였고 여전한 득점포를 과시하며 팀에 여러번의 우승을 안겼다.
시흥시	대한민국	country	과림동은  << _obj_ >>  경기도  << _sbj_ >> 의 행정동이다.
양상쿤	장쩌민	successor	 1992년에 중화인민공화국을 방문하여  << _obj_ >>  총서기와  << _sbj_ >>  국가주석 등에게 직접 만남을 제의, 정상회담을 개최해 중화인민공화국과의 외교 관계를 수립, 그 해에 몽골과도 외교 관계를 맺었다.
이만수	삼성_라이온즈	team	서울운동장에서 전두환 당시 대통령의 시구와 함께  << _obj_ >>   << _sbj_ >> 의 한국프로야구 1호 안타와 1호 홈런, 그리고 LG 트윈스의 이종도가 삼성 이선희  투수를 상대로 친 끝내기 만루홈런으로 시작되었다.
선동열	KIA_타이거즈	team	그 해  << _obj_ >> 의  << _sbj_ >> 이 24승 6패에 평균자책점 0.99라는 성적을 거두며 팀을 우승으로 이끌었다.
유지현_(야구인)	LG_트윈스	team	1994년  << _obj_ >> 의 신인 3인방,  << _sbj_ >> , 서용빈, 김재현 의 활약과 이광환 감독의 자율야구에 힘입어 LG 트윈스가 돌풍을 일으키며 그 해 우승까지 차지했다.
제후_무궤	제_효공	successor	 환공이 태자로 지목한  << _obj_ >>  대신 환공의 총신 역아와 초가 지지한  << _sbj_ >> 가 뒤를 이었고, 무궤는 효공을 앞세운 송 양공 주도의 제후연합군과 국내의 호응에 쫓겨나 죽었으나 제 소공 · 제 혜공 · 제 의공 세 형제가 효공의 즉위를 저지해 송 양공이 재차 제나라를 침입하고서야 효공은 즉위할 수 있었다.
아이리스_(드라마)	김태희	starring	 이후 2009년에는 《》를 통해 할리우드에 진출했으며, 같은 해에 KBS 드라마 《 << _sbj_ >> 》에  << _obj_ >> 와 함께 출연하게 되면서 6년 만에 텔레비전 드라마 배우로 복귀, 이 작품으로 KBS 연기대상 대상을 수상했다.
구리시	대한민국	country	과천시의 면적은 35.86 km²로 대한민국에서  << _sbj_ >> 에 이어 두 번째로 면적이 좁고,  << _obj_ >>  국토 면적의 0.036%, 경기도 면적의 0.35%를 차지하고 있으며, 과천시 전체 면적의 85.4%인 30.64 km²가 개발제한구역이다.
포틀랜드_섬	영국	country	당시 건축용 석재로 쓰이던  << _obj_ >>  남단부의  << _sbj_ >> 의 석회석인 포틀랜드 석재의 색이 회백색으로 비슷해서 포틀랜드 시멘트란 이름을 붙였다.
고스트_오브_걸프렌즈_패스트	제니퍼_가너	starring	2009년 스톤은 마크 워터스 감독의 로맨틱 코미디 영화 《 << _sbj_ >> 》에서 매슈 매코너헤이,  << _obj_ >> , 마이클 더글러스와 공동 출연하였다.
페이퍼맨_(2009년_영화)	제프_대니얼스	starring	 또한 같은 해에, 키어런 멀로니와 그의 아내 미셸이 공동 감독한 《 << _sbj_ >> 》에서  << _obj_ >> , 라이언 레이놀즈, 리사 쿠드로와 함께 출연하였다.
브로크백_마운틴	히스_레저	starring	윌리엄스는 2004년 오스트레일리아의 배우  << _obj_ >> 와 영화의 세트장에 만난 뒤, 3년 후에 《 << _sbj_ >> 》에서 공연을 하게 되면서 데이트를 시작했다.
보르쇼드어버우이젬플렌_주	헝가리	country	토커이는  << _obj_ >>  북동부  << _sbj_ >> 에 위치한 도시로, 면적은 28.2㎢, 인구는 5,009명, 인구 밀도는 177.62명/㎢이다.
라스트_에어벤더	M._나이트_샤말란	director	 특히  << _obj_ >>  감독과 《식스 센스 》, 《언브레이커블 》, 《싸인 》, 《해프닝 》, 《 << _sbj_ >> 》, 《애프터 어스》 등 거의 모든 작품들에서 함께 작업했다.
그레이터맨체스터_주	영국	country	로치데일은  << _obj_ >>  잉글랜드  << _sbj_ >> 의 도시로, 인구는 2011년 조사 기준 107,926명이다.
영_빅토리아	장마크_발레	director	 2009년, 블런트는  << _obj_ >> 가 감독을 맡고 줄리언 펠로스가 각본을 쓴 《 << _sbj_ >> 》에서 빅토리아 여왕 역으로 출연하였다.
사막에서_연어낚시	이완_맥그리거	starring	블런트는 2011년에 라세 할스트룀이 감독을 맡고  << _obj_ >> 와 크리스틴 스콧 토머스가 공동 주연으로 출연한, 영국의 코미디 영화 《 << _sbj_ >> 》에 주연을 맡았다.
5년째_약혼중	니컬러스_스톨러	director	 그녀는  << _obj_ >> 가 감독을 맡고 제이슨 시걸이 공동 주연으로 출연한, 2012년 영화 《 << _sbj_ >> 》에 주연을 맡았다.
타르투_주	에스토니아	country	엘바는  << _obj_ >>   << _sbj_ >> 에 위치한 도시로, 면적은 9.92㎢, 인구는 5,762명, 인구 밀도는 580명/㎢이다.
아미스타드	스티븐_스필버그	director	 런던 예술 아카데미에서 수학한 뒤 연극 무대에서 활동하다가,  << _obj_ >>  감독의 영화 《 << _sbj_ >> 》의 조역으로 데뷔하였다.
아일랜드_해	아일랜드	country	노어 강은  << _obj_ >>  렌스터 지방에서 발원하여,  << _sbj_ >> 로 흐르는 강이다.
페어웰,_마이_퀸	브누아_자코	director	2013년,  << _obj_ >> 의 《 << _sbj_ >> 》에 시도니 라보르드 역으로 출연하여 제38회 세자르상 여우주연상에 후보로 올랐다.
생_로랑_(영화)	베르트랑_보넬로	director	 그리고  << _obj_ >> 의 《 << _sbj_ >> 》에서는 뮤즈 루루 드 라 팔래즈 역을 맡았다.
마이_페어_레이디_(영화)	오드리_헵번	starring	코번트 가든은  << _obj_ >>  주연의 영화 《 << _sbj_ >> 》의 배경이 되기도 했다.
이즈오_섬	일본	country	 중국 대륙 동부 및 타이완 원산으로, 보소 반도와  << _sbj_ >> 을 통해  << _obj_ >> 에 유입되었다.
최희섭	KIA_타이거즈	team	시즌 첫 2루타 : 3월 30일,  << _obj_ >>   << _sbj_ >>  
김선빈_(야구_선수)	KIA_타이거즈	team	시즌 첫 실책 : 3월 30일,  << _obj_ >>   << _sbj_ >>  
헤어스프레이_(2007년_영화)	존_트래볼타	starring	 파이퍼는 2007년 여름  << _obj_ >> , 크리스토퍼 워컨, 퀸 라티파와 같이 출연한 동명의 브로드웨이 뮤지컬을 영화로 각색한 《 << _sbj_ >> 》에서 맡은 벨마 본 터슬 역, 클레어 데인스, 찰리 콕스, 로버트 드 니로 상대역으로 출연한 판타지 모험 영화 《스타더스트 》에서 맡은 고대 마녀 라미아 역 등 두 개의 주요한 여름 블록버스터에서 악역을 맡으며 스크린에 복귀했다.
뉴욕의_연인들_(2011년_영화)	게리_마셜	director	이후 잠깐의 휴식기를 가진 후, 파이퍼는  << _obj_ >> 의 2011년 로맨틱 코미디 영화 《 << _sbj_ >> 》에 출연하였고, 《피플 라이크 어스》에 크리스 파인의 상대역으로 출연하였다.
말라가	스페인	country	파블로 디에고 호세 프란시스코 데 파울라 후안 네포무세노 마리아 데 로스 레메디오스 크리스핀 크리스피니아노 데 라 산티시마 트리니다드 마르티르 파트리시오 클리토 루이스 이 피카소는  << _obj_ >>   << _sbj_ >> 에서 출생하였고 주로 프랑스에서 미술활동을 한 20세기의 대표적 서양 화가이자 조각가이다.
트렌토	이탈리아	country	트리엔트 공의회는 1545년부터 1563년까지 오늘날  << _obj_ >>  북부에 있는  << _sbj_ >> 와 볼로냐에서 소집된 로마 가톨릭교회의 매우 중요한 보편 공의회 중의 하나이다.
뉴잉글랜드	매사추세츠_주	country	세일럼 마녀 재판은 미국  << _sbj_ >>  지방의  << _obj_ >>  세일럼 마을에서 1692년 3월 1일에 시작되는 일련의 재판을 말한다.
MBK_엔터테인먼트	대한민국	country	갱키즈는  << _sbj_ >>  소속의  << _obj_ >>  7인조 걸 그룹이다.
UEFA_유로파리그_2011-12	아틀레티코_마드리드	team	이 경기의 승자인 첼시 FC는  << _sbj_ >> 의 승자인  << _obj_ >> 와 UEFA 슈퍼컵을 놓고 다투게 되며, FIFA 클럽 월드컵 2012에 유럽 축구 연맹 대표로서 진출할 자격이 주어졌다.
이규로	FC_서울	team	 K리그 2010  << _sbj_ >> 가  << _obj_ >> 로 이적한 이후 유지노와 번갈아 출전하며 주전 경쟁을 벌였다.
김재성_(축구_선수)	제주_유나이티드	team	 시즌 초 상주 상무 축구단에 입대했던  << _sbj_ >> 의 공백을 메울 대안으로 떠오른 이명주는 신인임에도 침착하고 센스 넘치는 패스 플레이와 공격적인 플레이 등으로 황선홍 감독의 눈에 들어 비교적 빨리 주전 자리를 차지하게 되었으며, 2012년 6월 23일  << _obj_ >> 와의 원정 경기에서 후반 38분 중거리슛으로 결승골이자 본인의 K리그 데뷔골을 터뜨렸다.
엔트레리오스_주	아르헨티나	country	파라나는  << _obj_ >>   << _sbj_ >> 의 주도이다.
데반_나이르	싱가포르	country	그는 1965년부터 1990년까지 유소프 빈 이샥과 벤저민 헨리 시어즈와  << _sbj_ >> 와 위킴위가 싱가포르의 대통령으로 재임하던 시기에  << _obj_ >> 의 권력이자 싱가포르의 총리로 재임하였다.
데반_나이르	위킴위	successor	그는 1965년부터 1990년까지 유소프 빈 이샥과 벤저민 헨리 시어즈와  << _sbj_ >> 와  << _obj_ >> 가 싱가포르의 대통령으로 재임하던 시기에 싱가포르의 권력이자 싱가포르의 총리로 재임하였다.
용쟁호투	이소룡	starring	영화 《 << _sbj_ >> 》에서  << _obj_ >> 은 많은 적들을 차례로 때려눕히게 되어 있었다.
용쟁호투	이소룡	starring	 싱하는  << _obj_ >> 이  << _sbj_ >> 에서 적을 쓰러뜨린 뒤 짓는 표정사진을 얼굴로 사용하며 악플을 남겼기 때문에 한때 이소룡이 싱하라 불리기도 했다.
용쟁호투	이소룡	starring	아역으로 영화에 데뷔하였고  << _obj_ >> 의 영화  << _sbj_ >>  오프닝에서 이소룡에게 도전하는 소림사 제자로 등장하여 관객들에게 깊은 인상을 주었다.
용쟁호투	이소룡	director	영화 《 << _sbj_ >> 》에서  << _obj_ >> 은 많은 적들을 차례로 때려눕히게 되어 있었다.
용쟁호투	이소룡	director	 싱하는  << _obj_ >> 이  << _sbj_ >> 에서 적을 쓰러뜨린 뒤 짓는 표정사진을 얼굴로 사용하며 악플을 남겼기 때문에 한때 이소룡이 싱하라 불리기도 했다.
용쟁호투	이소룡	director	아역으로 영화에 데뷔하였고  << _obj_ >> 의 영화  << _sbj_ >>  오프닝에서 이소룡에게 도전하는 소림사 제자로 등장하여 관객들에게 깊은 인상을 주었다.
엑스맨_(영화_시리즈)	브렛_래트너	director	  << _sbj_ >> 의 세 번째 작품으로, 전편의 브라이언 싱어가 하차하고  << _obj_ >> 가 연출하였다.
맨_인_블랙_2	토미_리_존스	starring	 로웰 커닝햄의 동명의 만화를 원작으로 15년전의 1997년 《맨 인 블랙》과 10년전의 2002년 《 << _sbj_ >> 》을 이은 속편으로  << _obj_ >> , 윌 스미스가 주연을 맡았고, 새롭게 조시 브롤린가 합류했다.
이와누마_시	일본	country	이와누마 역은  << _obj_ >>  미야기 현  << _sbj_ >> 에 있는 동일본 여객철도 · 일본화물철도의 철도역이다.
2000_UEFA_챔피언스리그_결승전	발렌시아_CF	team	 비록 프리메라리가 1999-2000 시즌에는 출장수가 급격하게 줄었으나,  << _obj_ >> 와의  << _sbj_ >> 에서 11분 출장하였고, 팀의 3-0 승리를 도왔다.
베스트피르디르	아이슬란드	country	바르다스트란다르시슬라는  << _obj_ >>  북서부에 있는 주로,  << _sbj_ >>  지역에 속한다.
빅토르_유셴코	빅토르_야누코비치	successor	쿠치마의 지지를 받은 여당 후보  << _obj_ >> 와 야당 지도자인  << _sbj_ >>  전 총리의 일대일 대결이라고 하는 형태가 되었다.
오스트리아-헝가리_제국_해군	오스트리아-헝가리_제국	country	안톤 하우스는  << _obj_ >> 의  << _sbj_ >>  제독이었다.
하인리히_1세	오토_1세	successor	작센공  << _sbj_ >> 의 아들  << _obj_ >> 가 962년에 교황 요한 12세로부터 대관됨으로써 신성 로마 제국이 성립되었다.
탈시	라트비아	country	탈시 구는  << _obj_ >>  북서부에 있던 구로 행정 중심지는  << _sbj_ >> 이며 면적은 2,744㎢, 인구는 49,662명, 인구 밀도는 17.8명/㎢이다.
발비	라트비아	country	발비 구는  << _obj_ >>  동부에 있던 구로 행정 중심지는  << _sbj_ >> 이며 면적은 2,381㎢, 인구는 28,246명, 인구 밀도는 11명/㎢이다.
알룩스네	라트비아	country	알룩스네 구는  << _obj_ >>  북동부에 있던 구로 행정 중심지는  << _sbj_ >> 이며 면적은 2,243㎢, 인구는 24,641명, 인구 밀도는 11명/㎢이다.
나자프_주	이라크	country	 쿠픽은  << _obj_ >>   << _sbj_ >> 의 도시인 쿠파에서 유래한 이름이다.
모토미야_시	일본	country	모토미야 역은  << _obj_ >>  후쿠시마 현  << _sbj_ >> 에 있는 동일본 여객철도 도호쿠 본선의 철도역이다.
송산_(야구_선수)	KIA_타이거즈	team	그의 단국대학교 동기로는 현 세인트루이스 카디널스 투수 오승환, 전  << _obj_ >>  포수  << _sbj_ >>  등이 있다.
존스타운_(펜실베이니아_주)	미국	country	존스타운 홍수 국립기념지는  << _obj_ >>  펜실베이니아 주  << _sbj_ >> 에서 발생한 존스타운 홍수로 인해 2,200명 이상이 사망한 일을 되새기기 위해 1964년 8월 31일 지정되었다.
UEFA_챔피언스리그_2001-02	바이어_04_레버쿠젠	team	막판까지 타이틀 레이스를 벌인 바이에른 뮌헨과 샬케 04는 모두  << _sbj_ >>  본선 직행 티켓을 손에 넣었고, 보루시아 도르트문트와  << _obj_ >> 은 같은 대회의 플레이오프에 합류하였다.
메르세데스-벤츠	독일	country	메르세데스-벤츠 W140은  << _obj_ >> 의 다임러 벤츠가  << _sbj_ >>  브랜드로 전개한 3번째 S클래스이다.
펄바_주	에스토니아	country	펄바는  << _obj_ >>  남동부에 위치한 도시로,  << _sbj_ >> 의 주도이며 면적은 5.5㎢, 인구는 6,314명, 인구 밀도는 1,100명/㎢이다.
김수항	김창집	child	 주요 인물로는 조선조 김번, 김극효, 김상용, 김상헌,  << _sbj_ >> ,  << _obj_ >> , 김창협, 김창흡, 김창업, 김원행, 김조순, 순원왕후, 김좌근, 김병연, 김병학, 김옥균, 김좌진등이 있다.
고요한	FC_서울	team	2002년  << _obj_ >>  스카우트로 선임되어 이청용, 고명진,  << _sbj_ >> , 송진형, 한동원 등을 발굴하는 데 일조하였으며 그 후 FC 서울의 유소년팀인 리틀 FC 서울의 코치를 거쳐 현재 대한민국 최초 FC 바르셀로나 공식 축구 학교, FCBESCOLA 시흥의 총감독으로 재직중이다.
한동원	FC_서울	team	2002년  << _obj_ >>  스카우트로 선임되어 이청용, 고명진, 고요한, 송진형,  << _sbj_ >>  등을 발굴하는 데 일조하였으며 그 후 FC 서울의 유소년팀인 리틀 FC 서울의 코치를 거쳐 현재 대한민국 최초 FC 바르셀로나 공식 축구 학교, FCBESCOLA 시흥의 총감독으로 재직중이다.
바실리카타_주	이탈리아	country	포텐차 현은  << _obj_ >>   << _sbj_ >> 의 이탈리아의 현이다.
미션_임파서블_(영화)	브라이언_드_팔마	director	  << _obj_ >> 의 1996년 영화  << _sbj_ >> 의 후속작이다.
돌렌스카	슬로베니아	country	벨라크라이나는  << _obj_ >>  남동부에 위치한 지방으로  << _sbj_ >>  남부에 위치한다.
한빛원자력발전소	대한민국	country	  << _obj_ >>  고리원자력발전소, 월성원자력발전소,  << _sbj_ >> , 한울원자력발전소 원자력 발전소에 총 10기가 운용중이거나 건설되고 있다.
레코_현	이탈리아	country	레코는  << _obj_ >>  북부 롬바르디아 주의 도시로,  << _sbj_ >> 의 현도이다.
북캅카스_연방관구	러시아	country	알렉산드르 겐나디예비치 흘로포닌은  << _obj_ >> 의 사업가이자 정치인으로, 2010년부터  << _sbj_ >>  대통령 전권 대표를 맡고 있다.
사쿠라_시_(도치기_현)	일본	country	가마스사카 역은  << _obj_ >>  도치기 현  << _sbj_ >> 에 있는 동일본 여객철도 도호쿠 본선의 철도역이다.
2010년_FIFA_월드컵_결승전	스페인_축구_국가대표팀	team	 4일 뒤 스코틀랜드는 타이틀을 월드컵 챔피언 이탈리아 축구 국가대표팀에게 넘겨주었으며 타이틀은 헝가리 축구 국가대표팀, 터키 축구 국가대표팀, 그리스 축구 국가대표팀와 스웨덴 축구 국가대표팀을 거쳐 네덜란드 축구 국가대표팀로 넘어가게 되었으며 네덜란드는  << _sbj_ >> 에서  << _obj_ >> 에 패배하기 까지 가장 성공적으로 타이틀을 방어해 내었다.
사망유희	이소룡	starring	 이 구성은 영화의 스토리완 전혀 다르며 굳이 따지면 작고한  << _obj_ >>  주연의 『 << _sbj_ >> 』와 비슷하다.
사망유희	이소룡	starring	 또한 자신의 무술 실력을 바탕으로  << _obj_ >> 의 마지막 작품인 《 << _sbj_ >> 》에서 합기도 고수로 출연했다.
사망유희	이소룡	starring	영화배우로서 활동하기도 하였으며 대표작으로는  << _obj_ >> 이 주연으로 나온  << _sbj_ >> , 이소룡 - 전사의 여행와 액션 진기명기, 에어플레인이 있다.
사망유희	이소룡	director	 이 구성은 영화의 스토리완 전혀 다르며 굳이 따지면 작고한  << _obj_ >>  주연의 『 << _sbj_ >> 』와 비슷하다.
사망유희	이소룡	director	 또한 자신의 무술 실력을 바탕으로  << _obj_ >> 의 마지막 작품인 《 << _sbj_ >> 》에서 합기도 고수로 출연했다.
사망유희	이소룡	director	영화배우로서 활동하기도 하였으며 대표작으로는  << _obj_ >> 이 주연으로 나온  << _sbj_ >> , 이소룡 - 전사의 여행와 액션 진기명기, 에어플레인이 있다.
전장의_크리스마스	사카모토_류이치	starring	오시마 나기사가 13년만에 메가폰을 잡은 작품으로, 영화 《 << _sbj_ >> 》 이래로 오시마 나기사, 기타노 타케시,  << _obj_ >>  트리오가 다시 만났으며, 마츠다 유사쿠의 아들인 마츠다 류헤이의 영화 첫 출연으로도 화제를 모았다.
럼_다이어리	조니_뎁	starring	 2010년에는 《존시스》와 《앤드 순 더 다크니스》, 《존 카펜터의 더 워드》에 출연하였으며, 《드라이브 앵그리》에는 니컬러스 케이지와 더불어 주연을 맡았으며, 《 << _sbj_ >> 》에는  << _obj_ >> 과 함께 영화를 찍었다.
주룽지	원자바오	successor	1999년 9월,  << _sbj_ >>  내각에서 국가발전계획위원회 부주임을 거쳐, 2003년  << _obj_ >>  내각에서 국무원 부비서장을 지냈다.
호뀌리	호한뜨엉	successor	2. 휘녕공주 -  << _sbj_ >> 의 정실부인이자  << _obj_ >> 의 생모, 호뀌리가 즉위하자마자 대자황후로 추존.
루이지_카도르나	아르만도_디아츠	successor	 카포레토 전투 후 해임된  << _sbj_ >> 의 후임자인 이탈리아군 최고사령관  << _obj_ >> 장군은 피아베 지역에 대해 방어라인을 강화하고 부대들을 집중 배치시켜 놓고 있는 실정이었다.
발트_해	독일	country	한자 동맹은 13세기~17세기에  << _obj_ >>  북쪽과  << _sbj_ >>  연안에 있는 여러 도시 사이에서 이루어졌던 연맹이다.
포_강	이탈리아	country	테베레 강은  << _obj_ >> 에 있는 강으로서 총 길이 406Km로  << _sbj_ >> 과 아디게 강 다음으로 긴 강이다.
에게르	헝가리	country	헤베시 주는  << _obj_ >>  북부에 위치한 주로 주도는  << _sbj_ >> 이며 면적은 3,637㎢, 인구는 328,000명, 인구 밀도는 90명/㎢이다.
페치_(헝가리)	헝가리	country	버러녀 주는  << _obj_ >>  남부에 위치한 주로 주도는  << _sbj_ >> 이며 면적은 4,430㎢, 인구는 396,600명, 인구 밀도는 90명/㎢이다.
아멜리에	오드리_토투	starring	 그가 할리우드에서 영화를 한 영향으로 다음 프로젝트  << _obj_ >>  주연의  << _sbj_ >> >를 쉽게 찍을수 있게 되었다.
코시체	슬로바키아	country	코시체 주는  << _obj_ >>  북동부에 위치한 주로, 주도는  << _sbj_ >> 이며 면적은 6,752㎢, 인구는 775,509명, 인구 밀도는 115명/㎢이다.
슈체코치니	폴란드	country	슈체코치니 열차 충돌 사고는 2012년 3월 3일  << _obj_ >>   << _sbj_ >> 에서 일어난 열차 충돌 사고이다.
이시노마키_시	일본	country	게센누마 선은  << _obj_ >>  미야기 현  << _sbj_ >> 의 마에야치 역부터 게센누마 시의 게센누마 역까지를 잇는, 동일본 여객철도의 지방 교통선이다.
우나기	이마무라_쇼헤이	director	 1997년 개봉된 《실락원 》도 큰 성공을 거뒀으며  << _obj_ >>  감독의 《 << _sbj_ >> 》가 칸 영화제 황금종려상을 수상하며, 2년간 20개 이상의 영화상을 수상했다.
비스와_강	폴란드	country	프워츠크는  << _obj_ >>  중부 마조프셰 주에 위치한 도시로,  << _sbj_ >> 과 접하며 면적은 88.06㎢, 높이는 60m, 인구는 126,675명, 인구 밀도는 1,400명/㎢이다.
산티아고_카니사레스	발렌시아_CF	team	 라울은  << _sbj_ >> 를 빙 돌아  << _obj_ >> 의 골네트를 갈랐다.
코르처_주	알바니아	country	포그라데츠는  << _obj_ >>  남동부에 위치한 도시로,  << _sbj_ >> 에 속하는 현인 포그라데츠 현의 현청 소재지이며 높이는 650m, 인구는 30,000명이다.
페친_현	알바니아	country	페친 또는 페치니는  << _obj_ >>  중부에 위치한 도시로, 엘바산 주에 속하는 현인  << _sbj_ >> 의 현청 소재지이며 인구는 약 10,000명이다.
크루여_현	알바니아	country	크루여 또는 크루야는  << _obj_ >>  중북부에 위치한 도시로, 두러스 주에 속하는 현인  << _sbj_ >> 의 현청 소재지이며 인구는 15,829명이다.
저메인_페넌트	리버풀_FC	team	 12월 16일, 그는  << _obj_ >> 와의 경기에서  << _sbj_ >> 를 넘어뜨려 페널티킥의 빌미를 제공하였다.
중앙그리스_주	그리스	country	리바디아는  << _obj_ >>  중부에 위치한 도시로,  << _sbj_ >> 에 속하는 현인 보이오티아 현의 현청 소재지이며 면적은 698.8㎢, 높이는 200m, 인구는 33,152명, 인구 밀도는 47명/㎢이다.
발터_울브리히트	빌리_슈토프	successor	 1973년 8월 1일  << _sbj_ >>  국가평의회 의장이 사망한 뒤부터 1973년 10월 3일  << _obj_ >> 가 국가평의회 새 의장으로 선출될 때가지 국가평의회 의장 권한대행을 역임했다.
브라차	불가리아	country	브라차 주는  << _obj_ >>  북서부에 위치한 주로, 주도는  << _sbj_ >> 이며 면적은 3,621.8㎢, 인구는 235,189명, 자동차 번호는 BP이다.
터르고비슈테	불가리아	country	터르고비슈테 주는  << _obj_ >>  북동부에 위치한 주로, 주도는  << _sbj_ >> 이며 면적은 2,716.5㎢, 인구는 137,689명, 자동차 번호는 T이다.
슬리벤	불가리아	country	슬리벤 주는  << _obj_ >>  남동부에 위치한 주로, 주도는  << _sbj_ >> 이며 면적은 3,544㎢, 인구는 218,474명, 자동차 번호는 CH이다.
로베치	불가리아	country	로베치 주는  << _obj_ >>  북서부에 위치한 주로, 주도는  << _sbj_ >> 이며 면적은 4,128.8㎢, 인구는 167,931명, 자동차 번호는 OB이다.
자카르파탸_주	우크라이나	country	 동쪽으로는 마라무레슈 주, 서쪽으로는 헝가리 서볼치서트마르베레그 주, 북쪽으로는  << _obj_ >>   << _sbj_ >> , 남쪽으로는 비호르 주, 설라지 주와 접하며 2개 시와 4개 마을, 59개 지방 자치체를 관할한다.
이바노프란키우스크_주	우크라이나	country	 동쪽으로는 수체아바 주, 서쪽으로는 사투마레 주, 북쪽으로는  << _obj_ >>   << _sbj_ >> 와 자카르파탸 주, 남쪽으로는 설라지 주와 클루지 주, 비스트리차너서우드 주와 접하며 2개 시와 11개 마을, 63개 지방 자치체를 관할한다.
브러일라	루마니아	country	브러일라 주는  << _obj_ >>  남동부 문테니아 지방에 위치한 주로, 주도는  << _sbj_ >> 이며 면적은 4,766㎢, 인구는 373,174명, 인구 밀도는 78명/㎢, ISO 3166-2 코드는 RO-BR이다.
부셰르_원자력_발전소	이란	country	 시만텍의 보안 대응팀 책임자인 Kevin Hogan은 감염된 시스템 중 약 60%가  << _obj_ >> 에 있으며, 따라서 이란의 중요 목표인  << _sbj_ >>  또는 나탄즈에 있는 우라늄 농축 시설 중 하나를 공격하는 것이라고 추측한다.
댄싱퀸_(영화)	대한민국	country	《 << _sbj_ >> 》은 이석훈 감독의 2012년  << _obj_ >> 의 코미디 영화이다.
아베디_펠레	릴_OSC	team	 그의 아버지,  << _sbj_ >> 는 프로 축구 선수로, 당시  << _obj_ >>  소속이었다.
병아리_(드라마)	아리무라_카스미	starring	2017년 《 << _sbj_ >> 》 -  << _obj_ >>
오카자키_시	일본	country	니시오카자키 역은  << _obj_ >>  아이치 현  << _sbj_ >> 에 있는 도카이 여객철도 도카이도 본선의 철도역이다.
부저우_주	루마니아	country	부저우는  << _obj_ >>  왈라키아 지방에 위치한 도시로,  << _sbj_ >> 의 주도이며 면적은 81.3㎢, 인구는 134,227명이다.
인크레더블	브래드_버드	director	《아이언 자이언트》는 《 << _sbj_ >> 》과 《라따뚜이》를 감독한  << _obj_ >> 의 애니메이션 영화로, 당시 극장 흥행에는 성공하지 못했으나 오랫동안 사랑을 받고 있으며 애니메이터들 사이에서 높이 평가받고 있다.
파리_대학교	프랑스	country	 1926년 3월  << _obj_ >>   << _sbj_ >>  문과를 졸업했고 같은 해 7월 17일 조선으로 귀국했다.
아라드_주	루마니아	country	아라드는  << _obj_ >>  서부에 위치한 도시로,  << _sbj_ >> 의 주도이며 면적은 46.18㎢, 인구는 167,238명이다.
니아리_주	콩고_공화국	country	음빈다는  << _obj_ >>  서부에 위치한  << _sbj_ >> 의 도시로, 가봉 국경과 가까운 지점에 위치한다.
문경은	서울_SK_나이츠	team	서울 SK 나이츠:  << _obj_ >> 의 2009년 스쿼드를 기준으로 만들어진 스페셜 캐릭터. 파워포워드인 김민수  방성윤, 포인트가드인 주희정, 스몰포워드인  << _sbj_ >> 을 선택할 수 있다.
리옹	프랑스	country	 2003년 6월 28일 레위니옹과  << _obj_ >>  파리  사이의 장거리 노선을 취항한데 이어 2005년 레위니옹과 마르세유 및  << _sbj_ >> 으로 이어지는 두 번째 장거리 노선을 열었다.
제_간공	제_평공	successor	 이와 같이 규성 전씨 재상이 제나라 임금과 같이 된 것은 증조부 전 성자가  << _sbj_ >> 을 시해하고  << _obj_ >> 을 옹립한 때부터 계속되었다.
마치바_구	세르비아	country	 세르비아 남북을 연결하는 이바르 고속도로, 아드리아 해 연안과 보스니아 헤르체고비나,  << _sbj_ >> 의 비옥한 지대와 보이보디나의 곡창 지대, 세르비아 서부의 주요 도시인 샤바츠, 우지체, 로즈니차, 바이나바슈타 등을 통과하는 아르테리알 고속도로가 발레보를 경유하며  << _obj_ >> 와 몬테네그로, 아드리아 해 연안을 연결하는 베오그라드-바르  철도가 지나간다.
니시_구_(하마마쓰_시)	일본	country	마이사카 역은  << _obj_ >>  시즈오카 현 하마마쓰 시  << _sbj_ >> 에 있는 도카이 여객철도의 철도역이다.
이와타_시	일본	country	도요다초 역은  << _obj_ >>  시즈오카 현  << _sbj_ >> 에 있는 도카이 여객철도의 철도역이다.
카타르_스타스_리그	카타르	country	 현재 소속팀은  << _obj_ >>   << _sbj_ >> 의 알아라비 스포츠 클럽이다.
스메데레보	세르비아	country	포두나블레 구는  << _obj_ >>  중부에 위치한 구로 행정 중심지는  << _sbj_ >> 이며 면적은 1,248㎢, 인구는 210,290명, 인구 밀도는 168.5명/㎢이다.
피로트	세르비아	country	피로트 구는  << _obj_ >>  남동부에 위치한 구로 행정 중심지는  << _sbj_ >> 이며 면적은 2,761㎢, 인구는 105,654명, 인구 밀도는 38.3명/㎢이다.
엣하르_다비츠	네덜란드_축구_국가대표팀	team	아약스는 1990년대에 판할의 리더쉽 하에 성공을 거두었으며,  << _obj_ >> 은 파트릭 클라위버르트, 마르크 오버르마르스, 데니스 베르흐캄프, 프랑크 더 부르, 로날트 더 부르,  << _sbj_ >> , 클라렌서 세이도르프, 빈스톤 보하르더, 미하얼 레이지허르, 에드빈 판데르사르의 아약스 선수들이 주축을 이루었다.
사나그_주	소말리아	country	에리가보는  << _obj_ >>  북부에 위치한 도시로,  << _sbj_ >> 의 주도이며 도시 인구는 180,000명, 광역 도시권 인구는 150,000명이다.
오라셰	보스니아_헤르체고비나	country	 슬라보니아 동부에 위치하며 사바 강을 경계로  << _obj_ >>   << _sbj_ >> 와 접한다.
타케크	라오스	country	우정의 다리는  << _obj_ >> 의 도시  << _sbj_ >> 와 타이의 주 나콘파놈 주를 연결하는 다리 이다.
시우다드델에스테	파라과이	country	우정의 다리는 브라질의 도시 포스두이구아수와  << _obj_ >> 의 도시  << _sbj_ >> 를 잇는 다리 이다.
벤저민_프랭클린	토머스_제퍼슨	successor	영국의 존 톨런드와 매슈 틴들, 프랑스의 볼테르, 디드로, 장 자크 루소, 특히 다수의 미국 건국의 아버지들,  << _obj_ >>  ,  << _sbj_ >>  등이 있다.
트러블맨	카토_시게아키	starring	《 << _sbj_ >> 》  주연:  << _obj_ >>  
아오이_호노오	야기라_유야	starring	《 << _sbj_ >> 》  주연:  << _obj_ >>
벨로바르	크로아티아	country	벨로바르빌로고라 주는  << _obj_ >>  중부에 위치한 주로 주도는  << _sbj_ >> 이며 면적은 2,652㎢, 인구는 133,084명, 인구 밀도는 50.2명/㎢이다.
문승원	SK_와이번스	team	 1989년 대졸 야구생으로 이규환, 이장희의 동기생으로는  << _obj_ >> 의  << _sbj_ >> , 한동민, 두산 베어스의 윤명준, 롯데 자이언츠의 신본기, 홍성민, KIA 타이거즈의 박지훈 , 윤완주, 임준섭, 황정립, LG 트윈스의 조윤준, 최성훈, 한화 이글스의 양성우, NC 다이노스의 나성범, 노진혁, 마낙길, 노성호 등이 있다.
황정립	KIA_타이거즈	team	 1989년 대졸 야구생으로 이규환, 이장희의 동기생으로는 SK 와이번스의 문승원, 한동민, 두산 베어스의 윤명준, 롯데 자이언츠의 신본기, 홍성민,  << _obj_ >> 의 박지훈 , 윤완주, 임준섭,  << _sbj_ >> , LG 트윈스의 조윤준, 최성훈, 한화 이글스의 양성우, NC 다이노스의 나성범, 노진혁, 마낙길, 노성호 등이 있다.
최영필	KIA_타이거즈	team	그의 형은 현  << _obj_ >> 의 투수  << _sbj_ >> 이다.
조광조_(드라마)	남일우	starring	 *  << _sbj_ >>  -  << _obj_ >>
즈데네크_포스페흐	FC_코펜하겐	team	 그는, 하지만, 2007년 가을에 라르스 야콥센을 대체하며,  << _sbj_ >> 가 복귀하기 전에 미드필더 자원 충족을 위하여  << _obj_ >> 과 계약을 맺었다.
카라뷔크_주	터키	country	사프란볼루는  << _obj_ >>   << _sbj_ >> 에 위치한 도시로, 면적은 1,000㎢, 높이는 485m, 인구는 47,257명이다.
잭슨_(미시시피_주)	미국	country	하비 존슨 주니어는  << _obj_ >> 의 정치인이자, 아프리카계 미국인 처음으로 선출된  << _sbj_ >> 의 시장이다.
흑해	조지아_(국가)	country	바투미 국제공항은  << _obj_ >>  남서쪽의 자치 공화국인 아자리야 공화국의 수도이자  << _sbj_ >>  연안 도시인 바투미 남쪽 2km에 위치한 국제공항이다.
에이벡스_엔터테인먼트	일본	country	다카시마 레이코는  << _obj_ >> 의 배우로, 소속사는  << _sbj_ >> 이다.
유욱_(유송)	유송_순제	successor	3. 송본기下제3 - 유송 명제・ << _sbj_ >> ・ << _obj_ >>
윈터스_본	데브라_그래닉	director	2010년 로렌스는  << _obj_ >>  감독의 《 << _sbj_ >> 》에 출연했는데, 이 영화는 선댄스 영화제에서 심사위원 대상을 수상하였고 현재 그의 성공의 계기가 되는 작품으로 자주 언급된다.
헝거_게임_(영화_시리즈)	제니퍼_로렌스	starring	2011년 4월, 라이언스게이트는 수잔 콜린스의 소설 시리즈 《헝거 게임 삼부작》을 원작으로 한 《 << _sbj_ >> 》에 허처슨을 피타 멜라크 역으로,  << _obj_ >> 를 캣니스 에버딘 역으로 캐스팅한 것을 발표하였다.
우구데이_칸	귀위크_칸	successor	2. 본기제2 -  << _sbj_ >> ・ << _obj_ >>
킬리스_주	터키	country	킬리스는  << _obj_ >>  중남부에 위치한 도시로,  << _sbj_ >> 의 주도이며 높이는 663m, 인구는 80,542명이다.
카라만_주	터키	country	카라만은  << _obj_ >>  중남부와 타우루스 산맥 북쪽에 위치한 도시로,  << _sbj_ >> 의 주도이며 높이는 1,039m, 인구는 132,064명이다.
초룸_주	터키	country	초룸은  << _obj_ >>  중북부에 위치한 도시로,  << _sbj_ >> 의 주도이며 면적은 12,820㎢, 높이는 801m, 인구는 218,130명이다.
동아나톨리아_지역	터키	country	이디르 주는  << _obj_ >>  동부에 위치한 주로,  << _sbj_ >> 에 속한다.
파리_대탈출	루이_드_퓌네스	starring	 또, 그는 1966년 영화  << _sbj_ >> 에서  << _obj_ >> 와 함께한 것으로 잘 알려져 있다.
저스틴_벌랜더	디트로이트_타이거스	team	 또, 아메리칸 리그에서도  << _obj_ >> 의  << _sbj_ >> 가 투수 트리플 크라운을 달성하면서 1924년 이후 87년만에 양리그에서 투수 트리플 크라운을 달성하게 된다.
오룔_주	러시아	country	리브니는  << _obj_ >>   << _sbj_ >>  남동부에 위치한 도시로, 인구는 52,841명이며 오룔에서 남동쪽으로 150km 정도 떨어진 곳에 위치한다.
콜리마_강	러시아	country	스레드네콜림스크는  << _obj_ >>  사하 공화국 북동부에 위치한 도시로, 야쿠츠크에서 북동쪽으로 1,485km 정도 떨어진 곳에 위치하며  << _sbj_ >>  좌안과 접한다.
도그마_(영화)	케빈_스미스	starring	 이후 같은 감독의 《황혼에서 새벽까지》에서 흡혈귀 여왕 산타니코 판데모니움 역, 《와일드 와일드 웨스트》에서 윌 스미스의 상대역,  << _obj_ >>  감독의 《 << _sbj_ >> 》에서 선지자 역 등을 맡았다.
도그마_(영화)	케빈_스미스	starring	 그는 이후 성년 코미디 《멍하고 혼돈스러운》와  << _obj_ >>  감독의 《몰래츠》, 《체이싱 아미》와 《 << _sbj_ >> 》를 포함한 여러 영화에 출연하였다.
도그마_(영화)	케빈_스미스	director	 이후 같은 감독의 《황혼에서 새벽까지》에서 흡혈귀 여왕 산타니코 판데모니움 역, 《와일드 와일드 웨스트》에서 윌 스미스의 상대역,  << _obj_ >>  감독의 《 << _sbj_ >> 》에서 선지자 역 등을 맡았다.
도그마_(영화)	케빈_스미스	director	 그는 이후 성년 코미디 《멍하고 혼돈스러운》와  << _obj_ >>  감독의 《몰래츠》, 《체이싱 아미》와 《 << _sbj_ >> 》를 포함한 여러 영화에 출연하였다.
화과자	일본	country	오코시모노는  << _obj_ >>  아이치 현에서 삼짇날에 먹는  << _sbj_ >> 의 일종이다.
랑스	프랑스	country	스타드 볼라르트 들렐리스는  << _obj_ >>   << _sbj_ >> 에 있는 축구 겸 럭비 경기장으로, RC 랑스의 홈 구장으로 사용되고 있으며 41,233명을 수용할 수 있다.
죽거나_혹은_나쁘거나	류승완	starring	그는 영화감독  << _obj_ >> 의 동생으로 2000년 그의 형인 류승완이 감독한 영화 《 << _sbj_ >> 》로 데뷔하였으며 2010년 제14회 부천국제판타스틱영화제 올해의 배우상을 수상하였다.
죽거나_혹은_나쁘거나	류승완	director	그는 영화감독  << _obj_ >> 의 동생으로 2000년 그의 형인 류승완이 감독한 영화 《 << _sbj_ >> 》로 데뷔하였으며 2010년 제14회 부천국제판타스틱영화제 올해의 배우상을 수상하였다.
대한민국_총무처	대한민국_행정자치부	successor	 1948년 7월 17일 정부 수립과 동시에 발족하였으며 1998년 2월 28일  << _sbj_ >> 와 통합하여  << _obj_ >> 로 개편되면서 폐지되었다.
샤위야와르디가_지방	모로코	country	세타트는  << _obj_ >>   << _sbj_ >> 의 행정 중심지로, 라바트와 마라케시 사이에 위치한다.
탐바쿤다_주	세네갈	country	탐바쿤다는  << _obj_ >>  동부에 위치한 도시로,  << _sbj_ >> 의 주도이며 인구는 78,800명이다.
잠베지_주	나미비아	country	카티마물릴로는  << _obj_ >>  북동부 카프리비 회랑에 위치한 도시로,  << _sbj_ >> 의 주도이며 인구는 22,134명이다.
옥스퍼드	영국	country	라이드는 1988년  << _obj_ >>   << _sbj_ >> 에서 결성된 얼터너티브 록 밴드이다.
마니카_주	모잠비크	country	시모이우는  << _obj_ >>   << _sbj_ >> 의 주도로, 모잠비크에서 5번째로 큰 도시이며 인구는 238,976명이다.
모시쿠_주	앙골라	country	루에나는  << _obj_ >>  중동부에 위치한 도시로,  << _sbj_ >> 의 주도이며 루안다에서 1,250km 정도 떨어진 곳에 위치한다.
무르쿠브_주	리비아	country	훔스는  << _obj_ >>   << _sbj_ >> 의 주도로, 인구는 201,943명이다.
요한_크라위프	페예노르트	team	1970년대에 들어서 토탈 풋볼  의 축구 스타일이  << _obj_ >> 와 AFC 아약스에 의해 개발되었고, 네덜란드 국가대표팀은  << _sbj_ >> 의 지휘를 받고, 리뉘스 미헐스 국가대표팀 감독 지휘봉을 잡았다.
무라트_야킨	그라스호퍼_클럽_취리히	team	야킨은 1995년 그의 고향인 FC 바젤에서 축구 경력을 시작하였으며,  << _obj_ >> , FC 장크트갈렌을 거친 뒤 2001년 자신의 친정팀인 FC 바젤로 복귀하여 친형인  << _sbj_ >> 과 함께 뛰어난 활약을 하였다.
도조_히데키	일본	country	날짜 미상 -  << _obj_ >>  야스쿠니 신사에  << _sbj_ >>  등 A급 전범 14명의 위패가 비밀리에 합사되다.
일리노이_공과대학교	미국	country	 방문학생제도의 파견 대학으로는  << _obj_ >> 의 아메리칸 대학교, 세인트 클라우드 주립 대학교,  << _sbj_ >> , 캐나다의 앨버타 대학교, 영국의 노팅엄 대학교, 킹스 칼리지 런던 등이 있다.
남딘	베트남	country	 7월 18일 아침이 되자  << _obj_ >>  전국에서 11명의 사람이 실종되었다고 집계되었고  << _sbj_ >> 에서는 폭우로 127 mm의 강수량을 기록했다.
볼리캄사이_주	라오스	country	  << _obj_ >> 에서는 캄무안 주와  << _sbj_ >> 의 저지대에서 홍수가 났고 태풍이 온 지 이틀이 지나도 25개의 마을과 학교 15개교가 물에 잠겨있었다.
글렌데일_(애리조나_주)	미국	country	유니버시티 오브 피닉스 스타디움은  << _obj_ >>  애리조나 주  << _sbj_ >> 에 있는 다목적 경기장이다.
내셔널_풋볼_리그	뉴잉글랜드_패트리어츠	team	  << _sbj_ >>   << _obj_ >> 와 메이저 리그 사커 뉴잉글랜드 레벌루션의 홈경기장이다.
온달_왕자들	김혜선_(배우)	starring	민지수 역에  << _obj_ >> 이 낙점되었지만 MBC  << _sbj_ >> 에 캐스팅되면서 출연을 포기하자 양정아가 대타로 들어갔다.
츠비카우	독일	country	트라반트 601은  << _obj_ >>  통일 이전 구 독일 민주 공화국  << _sbj_ >> 의 에서 만든 4인승 경차이다.
나쁜_남자_(영화)	김기덕_(1960년)	director	 이후 2002년 개봉한  << _obj_ >>  감독의 영화 《 << _sbj_ >> 》에 출연하여 주목을 받았고, 그해 대종상 신인여우상과 춘사나운규영화예술제 올해의 신인연기상 및 황금촬영상 신인여우상을 수상했다.
라이푸르	인도	country	빌라스푸르는  << _obj_ >>  차티스가르 주의 도시로,  << _sbj_ >> 에서 북쪽으로 111km 정도 떨어진 곳에 위치한다.
카롤_2세	미하이_1세	successor	1930년 루마니아 왕국에서는  << _sbj_ >> 가 자신의 아들  << _obj_ >> 를 밀어내고 왕위에 오르는 사건이 발생하였다.
홍명보	대한민국_축구_국가대표팀	team	 그러나 거스 히딩크가  << _obj_ >>  감독 부임한 이래로 최종수비수로 발탁되었고, 2002년 FIFA 월드컵에서  << _sbj_ >> , 김태영 과 함께 스리백의 한 축을 담당하여 대한민국의 월드컵 4강에 큰 공헌을 하였다.
다비드_루이스	첼시_FC	team	 그리고 2010-11 시즌 리그 36라운드  << _obj_ >> 와의 홈 경기에서 전반 35초 경  << _sbj_ >> 를 제치는 패스를 하비에르 에르난데스에게 연결해 줌으로써 선제골을 어시스트 하였다.
아부_무사브_알자르카위	알카에다	successor	목격자들에 의하면, 미군의 폭탄 공격을 받고 숨진 것으로 알려진 이라크  << _obj_ >>  지도자  << _sbj_ >> 가 숨지기 직전 미군들에게 배와 가슴을 구타당했다고 일부 언론이 보도했다.
공화국_직할구	타지키스탄	country	투르순조다는  << _obj_ >>  서부에 위치한  << _sbj_ >> 의 도시이다.
미엥지제츠포들라스키	폴란드	country	미엥지제츠포들라스키는  << _obj_ >> ,  << _sbj_ >> 에 위치한 철도역이다.
락까_주	시리아	country	락까는  << _obj_ >>  북부에 위치한 도시로,  << _sbj_ >> 의 주도이며 인구는 191,784명이다.
미스터_브레인	아야세_하루카	starring	 여자 주인공  << _obj_ >> 와 함께 출연하는 것은 2009년 《 << _sbj_ >> 》 이후 2년만이다.
추_강	카자흐스탄	country	 북쪽으로는  << _sbj_ >> 과 접하며  << _obj_ >> 과 국경을 접한다.
허정	장면	successor	 1960년 5월,  << _sbj_ >> 은 최경록을 육군참모총장에 채용하려 하였으나,  << _obj_ >>  민주당 대표최고위원과 인연이 있던 최경록은 허정의 참모총장직 제의를 사양하였었다.
크레펠트	독일	country	요제프 보이스는 1921년 5월 12일  << _obj_ >>  노르트라인베스트팔렌 주  << _sbj_ >> 에서 태어났다.
메르싱	말레이시아	country	클루앙은  << _obj_ >>  조호르 주 중부에 위치한 군이자 도시로, 조호르바루에서 북쪽으로 약 110km 정도 떨어진 곳에 위치하며 남동쪽으로는 바투파핫, 서쪽으로는  << _sbj_ >> , 남쪽으로는 스가맛과 접한다.
수틀레지_강	인도	country	루디아나는  << _obj_ >>  펀자브 주 의 도시로,  << _sbj_ >> 과 접하며 인구는 1,395,053명이다.
칼리만탄우타라_주	인도네시아	country	타라칸 섬은  << _obj_ >> 의 섬으로, 행정 구역상으로는  << _sbj_ >> 에 속한다.
시코쿠	일본	country	 3일 오전 9시에  << _obj_ >>   << _sbj_ >>  섬에 상륙한 후 북쪽으로 이동하기 시작하였다.
히마찰프라데시_주	인도	country	심라는  << _obj_ >>  북부  << _sbj_ >> 의 주도로, 인구는 392,542명, 면적은 25㎢이며 인구밀도는 120명/㎢, 높이는 해발 2,205m이다.
페르시아_만	이라크	country	움카스르는  << _obj_ >>  남동부에 위치한 바스라 주의 도시로,  << _sbj_ >> 과 접하며 쿠웨이트와는 조그마한 수로를 경계로 서로 마주보고 있다.
마이산_주	이라크	country	아마라는  << _obj_ >>  남동부에 위치한 도시로,  << _sbj_ >> 의 주도이며 인구는 420,000명이다.
술라이마니야_주	이라크	country	술라이마니야는  << _obj_ >>  쿠르드 자치구에 위치한 도시로,  << _sbj_ >> 의 주도이며 1784년 신설되었다.
유쾌한_도우미	서현진_(배우)	starring	 구혜선은 〈 << _sbj_ >> 〉의 주연배우  << _obj_ >> 을 첫 장편 영화에서도 여주인공으로 캐스팅했다.
떨리는_가슴	고아성	starring	딸 현서 역의  << _obj_ >> 은 MBC TV 드라마《 << _sbj_ >> 》에서 배두나와 같이 출연했는데, 이때의 인연으로 봉준호 감독이 현서 역을 캐스팅할때 배두나의 추천으로 고아성을 캐스팅했다.
테드_윌리엄스	보스턴_레드삭스	team	  << _obj_ >> 의  << _sbj_ >> 는 4할 타율이라는 목표에 도전하고 있었고, 디마지오는 연속경기 안타 기록에 도전하고 있었다.
권혁	한화_이글스	team	 6월 21일 마산야구장에서 열린  << _obj_ >> 와의 경기에서 7회 1사 3루에서  << _sbj_ >> 에게 볼넷을 얻어 낸 후에 지석훈 타석 때 2루 도루를 성공하면서 통산 9번째 10년 연속 두 자릿수 도루를 달성했다.
스캇_맥그레거_(1986년)	넥센_히어로즈	team	 10월 4일 마산야구장에서 열린  << _obj_ >> 와의 경기에서 0-0 이던 4회 2사 1,2루에서  << _sbj_ >> 를 상대로 좌중간 적시타를 쳤다.
아르툠	러시아	country	블라디보스토크 국제공항는  << _obj_ >>  프리모르스키 지방  << _sbj_ >> 에 있는 공항으로 블라디보스토크의 시내 중심지에서 북서쪽으로 약40㎞에 위치해 있다.
김문호	롯데_자이언츠	team	 하지만 이현곤의 외야플라이 때  << _obj_ >> 의 좌익수  << _sbj_ >> 의 정확한 송구와 포수 용덕한의 블로킹으로 홈에서 태그아웃 당하였고 팀은 2:3으로 패하였다.
내셔널_리그_(야구)	뉴욕_메츠	team	 아메리칸 리그 우승팀인 뉴욕 양키스와  << _sbj_ >>  우승팀인  << _obj_ >> 가 맞붙어 5차전 승부 끝에 뉴욕 양키스가 뉴욕 메츠를 4승 1패로 누르고 월드시리즈 우승을 차지했다.
진스하임	독일	country	라인 네카어 아레나  는  << _obj_ >>   << _sbj_ >> 에 위치한 다목적 경기장이다.
나콘파놈	타이	country	 메콩 강을 경계로  << _obj_ >>   << _sbj_ >> 과 접하며 인구는 35,000명이다.
꽝찌_성	베트남	country	동하는  << _obj_ >>  중부에 위치한  << _sbj_ >> 의 성도로, 면적은 72,96㎢, 인구는 82,046명이다.
바르_주	프랑스	country	스포르팅 클뢰브 툴롱은  << _obj_ >> 의 축구 클럽으로,  << _sbj_ >> 의 툴롱을 연고지로 한다.
샤로시_죄르지	헝가리_축구_국가대표팀	team	 가장 주목할 부분은 8강전에서 다음 프랑스에서 열린 월드컵에서 준우승을 하게 되는  << _obj_ >> 의 중앙 미드필더  << _sbj_ >> 를 상대로 한 경기였다.
콰드워_아사모아	유벤투스_FC	team	2012년 7월에 팀 동료인  << _sbj_ >> 와 함께 공동소유의 형태로  << _obj_ >> 로 이적하였다.
마티아스_페르난데스	비야레알_CF	team	 그의 이적은  << _obj_ >> 로 방출될 당시 $9M을 기록했던  << _sbj_ >> 의 클럽 이적료 기록을 갈아치웠다.
위르겐_클린스만	미국_축구_국가대표팀	team	 현  << _obj_ >> 의 감독이자 전 독일 국가대표 감독  << _sbj_ >> 은 레버쿠젠을 대신하여 베를린을 주 훈련 시설로 사용할 것임을 밝혔다.
오비에도	스페인	country	레알 오비에도는  << _obj_ >> 의 축구 클럽으로, 아스투리아스 지방의  << _sbj_ >> 를 연고지로 한다.
레페	이탈리아	country	UC 알비노레페는  << _obj_ >> 의 축구 클럽으로, 베르가모 현  << _sbj_ >> 와 알비노를 연고지로 한다.
UEFA_챔피언스리그_2014-15	FC_바르셀로나	team	 그리고  << _sbj_ >> 를 우승하면서 2014-15 시즌  << _obj_ >> 의 트레블에 일조하였다.
데스티네이션_(영화)	제임스_웡	director	 시리즈의  << _sbj_ >> 의 감독이었던  << _obj_ >> 이 다시 감독을 맡았다.
불새_(2004년_드라마)	이서진	starring	한편, 캐스팅 문제로 골머리를 썩였는데 배용준 이정재   << _obj_ >>  등이 한기주, 김희선이 강태영 역 물망에 올랐으나 배용준 이정재  김희선은 영화 촬영, 이서진은 MBC  << _sbj_ >>  출연으로 고사하자 설득 끝에 박신양이 한기주, 김정은 이 강태영 역으로 낙점됐다.
마라케시텐시프트엘하우즈_지방	모로코	country	에사우이라는  << _obj_ >>  서부와 대서양 연안에 위치한  << _sbj_ >> 의 도시이다.
손학규	김문수_(1951년)	successor	 이 선교회는 재야 활동가  << _sbj_ >> ,  << _obj_ >> , 오종세 등의 활동 무대였던 곳이다.
오로미아_주	에티오피아	country	모얄레는  << _obj_ >> 와 케냐 국경에 위치한 도시로, 시의 대부분 지역은 에티오피아  << _sbj_ >> 에 속하며 나머지는 케냐 동부 주  모얄레 구에 속한다.
중부_주_(케냐)	케냐	country	니에리는  << _obj_ >> 의 도시로,  << _sbj_ >> 의 주도이며 인구는 98,908명이다.
퀄컴	미국	country	 1996년부터  << _obj_ >> 의 모토로라,  << _sbj_ >>  등과 기술제휴를 맺고 휴대전화 사업을 본격 개시, 1999년부터 SK텔레텍에 휴대 전화 단말기 베가 를 납품하였고, LG텔레콤에도 카이 코코, 카이 코스모 등의 휴대 전화 단말기를 납품하였다.
콜드_마운틴	앤서니_밍겔라	director	 그녀의 세 번째 영화는  << _obj_ >> 의 전쟁 드라마 《 << _sbj_ >> 》이었다.
인제라	에티오피아	country	동북아프리카의  << _obj_ >> 에서는,  << _sbj_ >> 라 불리는 빵이 있으며, 테프 라 불리는 곡물로 만든다.
길주군	조선민주주의인민공화국	country	  << _obj_ >> 에서는 함경북도  << _sbj_ >> 에서 화석이 발굴되었으며, 일부는 천연기념물로 지정되어 있다.
오발라우_섬	피지	country	레부카는  << _obj_ >>   << _sbj_ >>  동부 연안에 위치한 도시로, 동부 구 의 행정 중심지이다.
제_호공	제_헌공	successor	여공 9년, 여공이 포악하였으므로, 제나라 사람들은 여공의 할아버지  << _obj_ >> 이 쫓아낸  << _sbj_ >> 의 아들을 모셔와 제후로 옹립하고자 해 여공을 공격하여 죽였다.
소코트라_섬	예멘	country	  << _sbj_ >> 은 대륙붕으로 이어진 아프리카의 섬으로 다루기는 하나, 아시아 나라인  << _obj_ >>  영토이다.
필리프_6세	장_2세_(프랑스)	child	  << _sbj_ >> 의 아들이자 외종사촌인  << _obj_ >> 가 시아버지로, 남편인 샤를 5세는 그녀에게 외종질에 해당한다.
필리프_6세	장_2세_(프랑스)	child	 그 당시 신임 도팽은 재임중인  << _sbj_ >> 의 손자이자 그의 법정추정상속인인 아들  << _obj_ >> 였다.
필리프_6세	장_2세_(프랑스)	successor	  << _sbj_ >> 의 아들이자 외종사촌인  << _obj_ >> 가 시아버지로, 남편인 샤를 5세는 그녀에게 외종질에 해당한다.
필리프_6세	장_2세_(프랑스)	successor	 그 당시 신임 도팽은 재임중인  << _sbj_ >> 의 손자이자 그의 법정추정상속인인 아들  << _obj_ >> 였다.
스트러셰니	몰도바	country	스트러셰니 구는  << _obj_ >>  중부에 위치한 구로 행정 중심지는  << _sbj_ >> 이며 면적은 730㎢, 인구는 91,300명이다.
오르헤이	몰도바	country	오르헤이 구는  << _obj_ >>  동부에 위치한 구로 행정 중심지는  << _sbj_ >> 이며 면적은 1,228㎢, 인구는 125,900명이다.
플로레슈티	몰도바	country	플로레슈티 구는  << _obj_ >>  북동부에 위치한 구로 행정 중심지는  << _sbj_ >> 이며 면적은 1,108㎢, 인구는 90,000명이다.
펄레슈티	몰도바	country	펄레슈티 구는  << _obj_ >>  북부에 위치한 구로 행정 중심지는  << _sbj_ >> 이며 면적은 1,073㎢, 인구는 92,600명이다.
칸테미르	몰도바	country	칸테미르 구는  << _obj_ >>  남부에 위치한 구로 행정 중심지는  << _sbj_ >> 이며 면적은 870㎢, 인구는 62,800명이다.
동방불패	임청하	starring	 한국에서 가장 유명한 것은 이연걸과  << _obj_ >>  주연의 영화  << _sbj_ >> 인데, 이 영화는 소오강호 소설 속의 일부 설정만 차용했고 실제 소설 내용과는 큰 차이를 보인다.
오카방고_강	보츠와나	country	북쪽으로는  << _sbj_ >> 을 경계로 앙골라 쿠안두쿠방구 주와 접하고 있었고 남동쪽으로는  << _obj_ >>  북서부 구 , 동쪽으로는 잠베지 주, 남쪽으로는 오초존주파 주, 서쪽으로는 오시코토 주, 북서쪽으로는 오항궤나 주와 접하고 있었으며 9개 선거구로 나뉘었다.
카티마물릴로	나미비아	country	잠베지 주는  << _obj_ >>  북동부에 위치한 주로, 주도는  << _sbj_ >> 이며 면적은 19,532㎢, 인구는 90,422명이다.
미들랜즈_주	짐바브웨	country	궤루는  << _obj_ >>  중부에 위치한 도시로,  << _sbj_ >> 의 주도이다.
비움바	르완다	country	북부 주는  << _obj_ >>  북부에 위치한 주로, 주도는  << _sbj_ >> 이며 면적은 3,293㎢, 인구는 1,650,704명이다.
닥터_후	영국	country	캡틴 잭 하크니스는  << _obj_ >> 의 드라마 《 << _sbj_ >> 》와 그 스핀오프 드라마 《토치우드》에 등장하는 가공의 인물로, 배우 존 바로우만이 연기하고 있다.
알렉산드르_2세	알렉산드르_3세	child	아버지 디미트리 파울로비치 대공은 파울 알렉산드로비치 대공의 아들로, 파울 알렉산드로비치 대공은  << _sbj_ >> 의 아들이자  << _obj_ >> 의 동생이었다.
알렉산드르_2세	알렉산드르_3세	child	제 16대  << _obj_ >>   -  << _sbj_ >> 의 차남.
알렉산드르_2세	알렉산드르_3세	successor	아버지 디미트리 파울로비치 대공은 파울 알렉산드로비치 대공의 아들로, 파울 알렉산드로비치 대공은  << _sbj_ >> 의 아들이자  << _obj_ >> 의 동생이었다.
알렉산드르_2세	알렉산드르_3세	successor	제 16대  << _obj_ >>   -  << _sbj_ >> 의 차남.
헨리_7세	헨리_8세	successor	 아버지 존 시모어 경은  << _sbj_ >> 와  << _obj_ >>  집권기간 중 군인으로 활약했었다.
나카요시	일본	country	《괴도 세인트 테일》는  << _obj_ >> 의 다치가와 메구미가 《 << _sbj_ >> 》에 연재한 만화이자 이를 원작으로 한 TV 애니메이션이다.
음친지	말라위	country	음친지 현는  << _obj_ >>  중부 주 에 위치한 현으로, 현도는  << _sbj_ >> 이며 면적은 3,356㎢, 인구는 324,941명이다.
샤를_5세	샤를_6세	child	  << _sbj_ >> 의 손자로  << _obj_ >> 의 조카, 루이 12세의 아버지이기도 하다.
샤를_5세	샤를_6세	child	  << _sbj_ >> 의 아들이자  << _obj_ >> 의 동생이며, 루이 12세는 그의 손자이다.
샤를_5세	샤를_6세	child	 1380년 큰형  << _sbj_ >> 가 세상을 떠나자 다른 두 형과 함께 아직 어린  << _obj_ >> 의 섭정이 되어 프랑스를 통치했다.
샤를_5세	샤를_6세	child	그 뒤 1377년 잉글랜드에서는 에드워드 3세가 죽고 리처드 2세가 왕위에 올랐으며, 프랑스에서도 1380년  << _sbj_ >> 가 죽고 그의 아들  << _obj_ >> 가 그 뒤를 이었다.
샤를_5세	샤를_6세	child	 1380년에  << _sbj_ >> 가 이미 사망하면서, 필리프와 함께 앙주 공작 루이, 베리 공작 장은 미성숙한  << _obj_ >> 의 섭정을 맡았다.
샤를_5세	샤를_6세	successor	  << _sbj_ >> 의 손자로  << _obj_ >> 의 조카, 루이 12세의 아버지이기도 하다.
샤를_5세	샤를_6세	successor	  << _sbj_ >> 의 아들이자  << _obj_ >> 의 동생이며, 루이 12세는 그의 손자이다.
샤를_5세	샤를_6세	successor	 1380년 큰형  << _sbj_ >> 가 세상을 떠나자 다른 두 형과 함께 아직 어린  << _obj_ >> 의 섭정이 되어 프랑스를 통치했다.
샤를_5세	샤를_6세	successor	그 뒤 1377년 잉글랜드에서는 에드워드 3세가 죽고 리처드 2세가 왕위에 올랐으며, 프랑스에서도 1380년  << _sbj_ >> 가 죽고 그의 아들  << _obj_ >> 가 그 뒤를 이었다.
샤를_5세	샤를_6세	successor	 1380년에  << _sbj_ >> 가 이미 사망하면서, 필리프와 함께 앙주 공작 루이, 베리 공작 장은 미성숙한  << _obj_ >> 의 섭정을 맡았다.
장_2세_(프랑스)	샤를_5세	successor	  << _sbj_ >> 의 차남으로 태어났으며,  << _obj_ >> 의 동생, 베리 공작 장, 부르고뉴 공작 필리프 2세의 형이다.
베르베라티	중앙아프리카_공화국	country	맘베레카데이 주는  << _obj_ >> 의 주로, 주도는  << _sbj_ >> 이며 면적은 30,203㎢, 인구는 289,688명, 인구밀도는 10명/㎢ 미만이다.
글로스터셔_주	영국	country	블랙웰은 1821년  << _obj_ >>  잉글랜드  << _sbj_ >>  브리스틀에서 설탕 정제업자 새뮤얼 블랙웰과 한나 블랙웰의 9남매 중 셋째로 태어났으며, 이 집안은 퀘이커 가정으로 노예 제도를 배격하였다.
대한민국_농림수산부	대한민국_농림부	successor	 1973년 3월 3일  << _obj_ >> 를 개편하여 발족하였으며 1987년 1월 1일  << _sbj_ >> 로 개편되면서 폐지되었다.
프리스테이트_주	남아프리카_공화국	country	 남서쪽으로는  << _obj_ >>   << _sbj_ >> , 남동쪽으로는 남아프리카 공화국 이스턴케이프 주와 인접해 있고 북서쪽으로는 마페텡 구, 북쪽으로는 마세루 구, 북동쪽으로는 타바체카 구와 인접해 있으며 동쪽으로는 카차스네크 구, 남동쪽으로는 쿠팅 구와 인접해 있다.
제_환공	제후_무궤	successor	  << _sbj_ >> 은  << _obj_ >> 를 보내 병사들을 보내 조읍을 지키게 하고, 또 물자들을 보내어 원조했다.
이마드_앗딘_장기	사이프_앗딘_가지_1세	child	 그는  << _sbj_ >> 의 4남이며, 맏형  << _obj_ >> 의 사후에 그의 영지를 계승했다.
이마드_앗딘_장기	사이프_앗딘_가지_1세	successor	 그는  << _sbj_ >> 의 4남이며, 맏형  << _obj_ >> 의 사후에 그의 영지를 계승했다.
살인의_추억	봉준호	director	 2000년 개봉한 이창동 감독의 영화 《박하사탕》에 조연으로 출연하며 연기 활동을 시작했고, 2003년 개봉한  << _obj_ >>  감독의 영화 《 << _sbj_ >> 》에도 조연으로 출연했다.
오아시스_(영화)	이창동	director	 고서희는  << _obj_ >>  감독과의 인연으로 이후 이창동 감독의 다음 영화인 《 << _sbj_ >> 》, 《밀양 》에 단역으로 출연하기도 했다.
장녹수_(드라마)	서갑숙	starring	《 << _sbj_ >> 》 -  << _obj_ >>
수_문제	수_양제	successor	후일 아들 수왕의 비 양귀비를 빼앗은 당나라 당 현종,  << _sbj_ >> 의 후궁 선화부인과 사통한  << _obj_ >>  등과 비견되기도 한다.
나쿠루	케냐	country	리프트밸리 주는  << _obj_ >> 의 주로, 주도는  << _sbj_ >> 이며 면적은 173,854㎢, 인구는 6,987,036명이다.
가리사	케냐	country	북동부 주는  << _obj_ >> 를 구성하는 8개 주 가운데 하나로 주도는  << _sbj_ >> 이며 면적은 126,902㎢, 인구는 962,143명이다.
코로고	코트디부아르	country	사반 주는  << _obj_ >> 를 구성하는 19개 주 가운데 하나로, 주도는  << _sbj_ >> 이며 면적은 40,323㎢, 인구는 1,215,100명이다.
2009_UEFA_챔피언스리그_결승전	맨체스터_유나이티드_FC	team	 결승전은 스페인의 FC 바르셀로나와 잉글랜드의  << _obj_ >> 가 맡붙게 되었으며, 이는  << _sbj_ >>  이후 2년만이다.
리빙스턴_(잠비아)	잠비아	country	남부 주는  << _obj_ >> 를 구성하는 10개 주 가운데 하나로 주도는  << _sbj_ >> 이며 면적은 85,823㎢, 인구는 1,853,464명, 인구 밀도는 22명/㎢이다.
카사마	잠비아	country	북부 주는  << _obj_ >> 를 구성하는 10개 주 가운데 하나로 주도는  << _sbj_ >> 이며 면적은 77,650㎢, 인구는 1,304,435명, 인구 밀도는 17명/㎢이다.
치파타	잠비아	country	동부 주는  << _obj_ >> 를 구성하는 10개 주 가운데 하나로 주도는  << _sbj_ >> 이며 면적은 51,476㎢, 인구는 1,813,445명, 인구 밀도는 35명/㎢이다.
날루트	리비아	country	날루트 주는  << _obj_ >>  북서부에 위치한 주로, 주도는  << _sbj_ >> 이며 인구는 93,224명이다.
바파타	기니비사우	country	바파타 주는  << _obj_ >>  중북부에 위치한 주로, 주도는  << _sbj_ >> 이며 면적은 5,981㎢, 인구는 225,516명이다.
보르_(남수단)	남수단	country	종글레이 주는  << _obj_ >>  동부 상나일 지방에 위치한 주로 주도는  << _sbj_ >> 이며 면적은 26,728.7㎢, 인구는 521,750명이다.
캉칸	기니	country	캉칸 주는  << _obj_ >> 의 주로, 주도는  << _sbj_ >> 이며 인구는 1,011,644명, 면적은 71,245㎢, 인구 밀도는 14.02명/㎢이다.
국가보안위원회	해외정보국	successor	 과거 막강한 권력을 가지고 있던 경쟁기관  << _sbj_ >> 가 8월 쿠데타로 몰락하면서 현재의 러시아 연방보안국과  << _obj_ >> 으로 분열된 것과는 달리, 정보총국은 군부의 산하기관으로서 소비에트 연방 붕괴 이전의 규모를 그대로 유지할 수 있었다.
캄포바소_현	이탈리아	country	캄포바소는  << _obj_ >>  몰리세 주  << _sbj_ >> 의 코무네다.
마쓰모토_게이지로	요코하마_DeNA_베이스타스	team	 그 해 가을에 열린 프로 야구 드래프트 회의에서는  << _obj_ >> 로부터 4순위 지명을 받아 세계 대학 야구 선수권 대회에서 팀 동료가 된 야마자키 노리하루,  << _sbj_ >> 와 함께 입단했다.
사브리나	오드리_헵번	starring	 1954년에는 빌리 와일더가 다시 감독을 맡고 험프리 보가트와  << _obj_ >> 이 출연한 《 << _sbj_ >> 》에 출연하였으며, 그레이스 켈리와 함께 한국 전쟁을 배경으로 한 《원한의 도곡리 다리》에 출연한다.
도쿠가와_쓰나요시	도쿠가와_이에노부	successor	준쇼인의 사후 26년 뒤, 5대 쇼군  << _sbj_ >> 가 후사 없이 사망하자 쥰쇼인의 손자  << _obj_ >> 가 6대 쇼군으로 취임하였다.
알프_아르슬란	말리크샤_1세	child	아크손쿠르 또는 아크 순쿠르  하집은 셀주크 제국의 술탄  << _sbj_ >> 과  << _obj_ >> 의 맘룩이었다.
알프_아르슬란	말리크샤_1세	child	1063년 이후로 그는 재상으로서 셀주크 가문을 받들었는데, 이 지위는  << _sbj_ >> 와  << _obj_ >> 의 치세 내내 유지되었다.
알프_아르슬란	말리크샤_1세	child	특히 셀주크 왕조의 술탄  << _sbj_ >> 이 아들  << _obj_ >> 의 아타베그로 임명한 페르시아 관료 니잠 알 물크를 재상으로 삼아 제국의 지배력강화를 위해 이용하는 자들도 있었으나, 미성년의 왕자(갓난아기일 때의 상황도 있다.
알프_아르슬란	말리크샤_1세	successor	아크손쿠르 또는 아크 순쿠르  하집은 셀주크 제국의 술탄  << _sbj_ >> 과  << _obj_ >> 의 맘룩이었다.
알프_아르슬란	말리크샤_1세	successor	1063년 이후로 그는 재상으로서 셀주크 가문을 받들었는데, 이 지위는  << _sbj_ >> 와  << _obj_ >> 의 치세 내내 유지되었다.
알프_아르슬란	말리크샤_1세	successor	특히 셀주크 왕조의 술탄  << _sbj_ >> 이 아들  << _obj_ >> 의 아타베그로 임명한 페르시아 관료 니잠 알 물크를 재상으로 삼아 제국의 지배력강화를 위해 이용하는 자들도 있었으나, 미성년의 왕자(갓난아기일 때의 상황도 있다.
클라크_군_(네바다_주)	미국	country	 그리고 1997년 10월 12일 서태지와 이지아는 각각 26세, 20세의 나이로  << _obj_ >> 에서 둘만의 결혼식을 올렸고, 10월 21일 서태지는 미국 네바다주  << _sbj_ >>  법원에 이지아와의 혼인신고서를 제출했다.
수와이다	시리아	country	수와이다 주는  << _obj_ >> 를 구성하는 14개 주 가운데 하나로, 주도는  << _sbj_ >> 이며 면적은 5,550㎢, 인구는 346,000명이다.
다라	시리아	country	다라 주는  << _obj_ >> 를 구성하는 14개 주 가운데 하나로, 주도는  << _sbj_ >> 이며 면적은 3,730㎢, 인구는 916,000명이다.
SMAP×SMAP	나카이_마사히로	starring	 또 같은 해 1월 26일에 방송 된 《 << _sbj_ >> 》의 "THE AGE CARD"에 게스트로 출연했을 때, 함께 출연한 우메미야 안나,  << _obj_ >> , 키무라 타쿠야와 동급생인 것을 공표.
프랑슈콩테	프랑스	country	테리투아르드벨포르 주는  << _obj_ >>  동부에 위치한  << _sbj_ >>  지방의 프랑스의 주로, 주도는 벨포르이며 인구는 144,600명, 면적은 609㎢, 인구밀도는 237.4명/㎢이다.
오세르	프랑스	country	욘 주는  << _obj_ >>  부르고뉴 지방의 프랑스의 주로, 주도는  << _sbj_ >> 이며 인구는 352,585명, 면적은 7,427㎢, 인구밀도는 47.5명/㎢이다.
느베르	프랑스	country	니에브르 주는  << _obj_ >>  중부에 위치한 프랑스의 주로, 주도는  << _sbj_ >> 이며 인구는 228,969명, 면적은 6,817㎢, 인구밀도는 33.6명/㎢이다.
마쓰다_노부히로	후쿠오카_소프트뱅크_호크스	team	 8월 12일의  << _obj_ >> 전에서는 프로 데뷔 첫 선발 투수를 맡아 5이닝 2사까지는 무안타로 처리하면서도 이후  << _sbj_ >> 에게 동점 적시타를 허용하는 등 역전을 당해 프로 첫 승리는 다음으로 미뤄졌다.
윌리엄_하워드_태프트	우드로_윌슨	successor	1912년 미국 대통령 선거는 1912년 미국에서 치러진 대통령 선거로, 공화당이  << _sbj_ >>  대통령과 시어도어 루즈벨트 전 대통령으로 분열되면서, 민주당의  << _obj_ >>  후보가 당선되어 16년만의 정권교체가 이루어졌다.
존_F._케네디	린든_B._존슨	successor	1960년 미국 대통령 선거는 민주당  전당대회에서  << _obj_ >> 을 꺾은  << _sbj_ >> 가 출마하고 공화당  전당대회에서 리처드 M. 닉슨이 후보로 지명되면서 치열한 접전이 예상되었다.
아카바	요르단	country	아카바 주는  << _obj_ >>  남부에 있는 주로, 주도는  << _sbj_ >> 이며 면적은 6,583㎢, 인구는 107,115명이다.
주하이_시	중화인민공화국	country	주하이 완산 해양 개발 시험구는  << _obj_ >>  광둥 성  << _sbj_ >> 에 있는 해양 종합 개발 시험구로, 1998년 9월 광둥 성 정부의 비준을 계기로 신설되었다.
카르발라	이라크	country	카르발라 주는  << _obj_ >> 의 주로 주도는  << _sbj_ >> 이며 면적은 5,034㎢, 인구는 724,000명이다.
쿠트	이라크	country	와시트 주는  << _obj_ >>  동부에 위치한 주로 주도는  << _sbj_ >> 이며 면적은 17,153㎢, 인구는 913,000명이다.
윌리엄스_대학교	미국	country	 1966년  << _obj_ >> 으로 건너가  << _sbj_ >> 에 입학하였으며 경제학 석사학위를 받았다.
아무다리야_강	아프가니스탄	country	  << _sbj_ >> 을 경계로 우즈베키스탄,  << _obj_ >> 과 국경을 접한다.
프리츠_발터	독일_축구_국가대표팀	team	 경기장 명칭은 1954년 FIFA 월드컵에서  << _obj_ >>  주장을 맡으면서 독일의 사상 첫 FIFA 월드컵 우승을 이끈 카이저슬라우테른 출신 축구 선수인  << _sbj_ >> 의 업적을 기념하기 위해 붙여진 이름이다.
페르가나_분지	타지키스탄	country	나망간 주는 우즈베키스탄의 행정 구역으로, 우즈베키스탄 동부  << _sbj_ >>  남부에 위치하고 있으며 타슈켄트 주와 페르가나 주, 안디잔 주, 키르기스스탄,  << _obj_ >> 과 인접해 있다.
아무다리야_강	투르크메니스탄	country	호레즘 주는 우즈베키스탄의 행정 구역으로, 우즈베키스탄 북서부  << _sbj_ >>  하류에 위치하고 있으며 부하라 주와 카라칼파크스탄,  << _obj_ >> 과 인접해 있다.
이재성_(1988년)	울산_현대_축구단	team	 2016년 시즌 후 이용 ,  << _sbj_ >> 과의 트레이드를 통해 김창수 , 최규백과 함께  << _obj_ >> 로 이적하였다.
잔루이지_부폰	유벤투스_FC	team	그의 이적료 1800만 파운드는  << _obj_ >> 의  << _sbj_ >> 이 기록한 3260만 파운드에 이은 기록이다.
사기_(역사서)	한나라	country	 《 << _sbj_ >> 》 등  << _obj_ >> 의 서적에서는 전한 경제를 피휘하여 이름을 뜻과 발음이 비슷한 '개'로 표기한다.
뜨랏_주	타이	country	 북쪽으로는 바탐방 주, 남쪽으로는 코콩 주, 북동쪽으로는 톤레사프 호와 인접해 있으며 동쪽으로는 캄퐁치낭 주, 남동쪽으로는 캄퐁스페우 주, 서쪽으로는  << _obj_ >>   << _sbj_ >> 와 인접해 있다.
캔디_(도시)	스리랑카	country	중부 주는  << _obj_ >>  중부에 있는 스리랑카의 행정 구역로, 주도는  << _sbj_ >> 이며 면적은 5,674㎢, 인구는 2,423,966명이다.
내_여자친구는_구미호	이승기	starring	〈정신이 나갔었나봐〉는 이승기가 드라마를 하면서 처음으로 직접 OST에 참여한 곡이며, 용감한 형제가  << _obj_ >> 의  << _sbj_ >>  캐스팅 소식을 듣고 작사, 작곡하여 이승기에게 선물한 곡이기도 하다.
얼티밋_파이팅_챔피언십	미국	country	UFC 128: Shogun vs. Jones는 2011년 3월 19일에  << _obj_ >>  뉴저지 주 뉴어크 의 푸르덴셜 센터에서 개최된 종합격투기인  << _sbj_ >>  경기이다.
신치_정	일본	country	신치 역은  << _obj_ >>  후쿠시마 현 소마 군  << _sbj_ >> 에 있는 동일본 여객철도의 철도역이다.
마나도	인도네시아	country	술라웨시우타라 주는  << _obj_ >> 의 주 가운데 하나로, 주도는  << _sbj_ >> 이며 인구는 2,265,937명, 면적은 15,359㎢이다.
원_무종	원_인종	successor	 원 세조 쿠빌라이의 고손녀로, 원 성종과는 6촌,  << _sbj_ >> 과  << _obj_ >> , 원 태정제와는 7촌간이다.
우카시_파비안스키	아스널_FC	team	 아스널에서 2009-10 시즌에는 마누엘 알무니아와  << _sbj_ >> 를 대신해서 출전하였고 2009년 9월 16일에 열린  << _obj_ >> 과 스탕다르 리에주의 UEFA 챔피언스리그 2009-10 조별 예선 경기에 출전하였다.
모하메드_울드_압델_아지즈	모리타니	country	2011년 2월 21일 아비장에는 사태 중재를 위해  << _sbj_ >>   << _obj_ >>  대통령, 제이컵 주마 남아프리카 공화국 대통령 등 아프리카 대통령 4명이 도착하여 양측과 면담하였으나, 그 사이에도 로랑 그바그보를 추종하는 정부군이 아비장 내 친야당 세력 구역에 공격을 가해 최소 6명이 숨졌다.
가나가와_구	일본	country	요코하마하자와 역은  << _obj_ >>  가나가와 현 요코하마 시  << _sbj_ >> 에 있는 일본화물철도와 동일본 여객철도의 화물역이다.
탐마삿_대학교	타이	country	 정치가로서는 제7대  << _obj_ >>  총리와 타이 왕국 섭정직을 역임하였으며, 사회 운동가로서는  << _sbj_ >> 를 설립하고 제2차 세계대전 동안 자유 타이 운동을 이끄는 등의 업적을 남겼다.
아시샤말	카타르	country	아시샤말 경기장은  << _obj_ >>   << _sbj_ >> 에 위치해있다.
포트빌라	바누아투	country	포트빌라 바우어필드 국제공항은  << _obj_ >> 의 수도  << _sbj_ >> 에 위치한 국제공항이다.
헬몬트	네덜란드	country	헬몬트 스포르트는 1967년 7월 27일에 창단된  << _obj_ >>   << _sbj_ >> 의 축구 클럽으로, 현재 에이르스터 디비시에서 활동하고 있다.
즈볼러	네덜란드	country	PEC 즈볼러는  << _obj_ >>   << _sbj_ >> 의 축구 클럽으로, 현재 에레디비시에서 활동하고 있다.
색,_계	리안	director	탕웨이는 이후, 텔레비전 드라마나 연극 등에 출연 하던 중에  << _obj_ >>  감독의 《 << _sbj_ >> 》의 오디션에서 약 1만명 중에서 주연으로 캐스팅 되어 정보부 대장 "이"를 암살하려는 여자 스파이 "왕치아즈 역"을 연기, 파격적인 성 묘사를 그린 작품 속에서의 연기가 큰 화제가 되었고, 이 작품은 제64회 베니스 국제영화제 황금사자상을 수상하며 일약 세계적인 스타로 부상했다.
아부_사이드_(티무르_왕조)	사마르칸드	successor	 1457년에 바부르가 죽자  << _obj_ >> 를 지배하던  << _sbj_ >> 가 호라산을 침공했고, 이후 후세인은 잠시나마 용병의 삶을 살았다.
아이리스_(드라마)	김승우	starring	본래 형사과장 정일도 역에  << _obj_ >> 가 캐스팅되어 포스터 촬영까지 마쳤으나, 2009년에 출연했던 드라마 《 << _sbj_ >> 》에서 촬영 중 당했던 어깨 부상으로 인해 도중 하차할 수 밖에 없었고, 이에 김승우 대신 이종혁  교체.
노키아_N810	노키아_N900	successor	또, GStreamer는 Palm Pre, 노키아 770, 노키아 N800,  << _sbj_ >> ,  << _obj_ >>  인터넷 태블릿과 같이 마에모 운영 체제를 사용하는 임베디드 기기에서도 동작한다.
블레인_(워싱턴_주)	미국	country	104. 2월 9일: 리치먼드  → 피스 아치 →  << _obj_ >>  워싱턴 주의  << _sbj_ >>
볼히니아	우크라이나	country	지토미르는  << _obj_ >> 의  << _sbj_ >>  지방에 위치하는 도시이자 우크라이나 지토미르 주의 주도이며, 인구는 2004년의 조사로는 27만 1200명이다.
왕의_남자	이준익	director	2005년  << _obj_ >>  감독의 영화 《 << _sbj_ >> 》에서 오디션을 통해 1000대 1의 경쟁률을 뚫고 여장 광대 ‘공길’ 역으로 캐스팅됐다.
첫눈_(영화)	미야자키_아오이	starring	 11월에는  << _obj_ >> 와 호흡을 맞춘 한일합작 영화 《 << _sbj_ >> 》이 한국에서 선보였다.
명성황후_(드라마)	이진우_(배우)	starring	《 << _sbj_ >> 》 KBS, 2001년~2002년, 배우: << _obj_ >> , 이인
무함마드_엘바라데이	아마노_유키야	successor	 사무총장은 1981년부터 1997년까지 한스 블릭스 사무총장이 그 이후에는  << _sbj_ >> , 2009년 12월부터는  << _obj_ >> 가 취임했다.
최규하	전두환	successor	12·12 군사 반란은 1979년 12월 12일,  << _obj_ >> 과 노태우를 중심으로 한 신군부 세력이  << _sbj_ >>  대통령의 승인 없이 계엄사령관인 정승화 대한민국의 육군참모총장, 장태완 수도방위사령부 그리고 정병주 대한민국 육군 특수전사령부을 연행한 사건이다.
브로니스와프_코모로프스키	폴란드	country	  << _obj_ >> 의 前 대통령인  << _sbj_ >> 와 사촌 지간이다.
박성호_(야구_선수)	한화_이글스	team	  << _obj_ >> 는  << _sbj_ >> , 이종환 , 임준섭을 받았다.
난터우_시	중화민국	country	중싱 신촌은  << _obj_ >>  타이완 성 난터우 현  << _sbj_ >> 에 있는 신도시이다.
스몰란드	스웨덴	country	벡셰는  << _obj_ >>  남부  << _sbj_ >>  지방에 위치한 도시로, 크로노베리 주의 주도이다.
응오딘지엠	즈엉반민	successor	 1963년  << _obj_ >> 의 쿠데타에 협력하여  << _sbj_ >>  축출에 성공하였으며, 1964년 응우옌카인 정권에서 육군 참모 총장, 1965년 판후이콱 내각의 부수상 겸 국방부장관을 지냈다.
프렌즈	코트니_콕스	starring	 그는 이후 《 << _sbj_ >> 》로 잘 알려진 여배우  << _obj_ >> 와 1989년부터 1995년까지 연인 관계였다.
쿠라_강	조지아_(국가)	country	바르지아 동굴 도시는  << _obj_ >>  남부의 아스핀자 근교  << _sbj_ >> 의 좌측 제방이 있는 에루셸리 산의 측면에 동굴들을 내어 구축한 동굴 수도원이다.
쇠데르텔리에	스웨덴	country	아쉬리스카 FF는 1974년에 창단된  << _obj_ >>   << _sbj_ >> 의 축구 클럽으로, 현재 수페레탄에서 활동하고 있다.
회네포스	노르웨이	country	회네포스 BK은 1895년에 창단된  << _obj_ >>   << _sbj_ >> 의 축구 클럽으로, 현재 아데콜리겐에서 활동하고 있다.
링컨_(뉴질랜드)	뉴질랜드	country	링컨대학교 는  << _obj_ >>  남섬 크라이스트처치 교외 셀윈 구  << _sbj_ >> 에 소재하는 대학이다.
브와디스와프_고무우카	볼레스와프_비에루트	successor	  << _sbj_ >> 와  << _obj_ >> 가 주도하는 폴란드 공산주의자들은 자신들의 지지가 약하다는 것을 알고 있었는데, 특히 "3번의 동의"이라는 정책에 대한 국민 투표에서 대규모 공산주의식 토지 개혁과 산업 국유화 등 제시된 개혁에 지지한 비중이 폴란드 인구의 1/3도 되지 않아 부결되었다.
오스카르_1세	칼_15세	successor	 그녀는  << _sbj_ >> 의 아들이자  << _obj_ >> 의 동생인 오스카르 왕자와 결혼했으며, 오스카르 왕자가 형의 뒤를 이어 오스카르 2세로 즉위한후 스웨덴의 왕비가 되었다.
클루지_주	루마니아	country	지우르텔레쿠심레울루이는  << _obj_ >>  서북부  << _sbj_ >> 에 있는 도시이다.
하후돈	하후무	child	  << _sbj_ >> 의 아들  << _obj_ >> 가 더 낫습니다.
아가씨를_부탁해	윤상현_(배우)	starring	드라마  << _sbj_ >>  OST  : 노래 -  << _obj_ >>
역도산_(영화)	송해성	director	설경구는 2003년,실미도 사건을 실사영화로 제작해 대한민국 영화사상 최초의 관객수 천만을 돌파한 강우석 감독의 영화 《실미도 》에 684 북파부대의 공작원 '강인찬' 역으로 출연한 데 이어, 2004년에는  << _obj_ >>  감독의 한일 합작 영화《 << _sbj_ >> 》에서 일본 프로레슬링의 황금기를 구가했던 재일교포 프로레슬러 역도산 역할을 맡아 전체 대사의 98%를 차지하는 일본어 대사로 인해 당시 송해성 감독으로부터 더빙을 제의 받았지만 "그건 죽기보다 싫다.
나는_행복합니다	윤종찬	director	현빈은 2008년 배우에게 혹독하기로 유명한  << _obj_ >>  감독의 영화 《 << _sbj_ >> 》를 선택하여 과대망상증환자 "조만수"역을 연기하였다.
사랑한다,_사랑하지_않는다	이윤기_(영화_감독)	director	 두 번째는  << _obj_ >>  감독의 영화 《 << _sbj_ >> 》에서 아내의 갑작스러운 이별 통보에도 세심한 배려를 하는 속마음을 알 수 없는 남편 "황지석" 역을 연기하였으며, 임수정 과 함께 노개런티로 출연했다.
김승우의_승승장구	김승우	starring	 그러나 경쟁 프로그램 강심장에 밀려 폐지가 확정되어, 2010년 1월 26일 265회에 하이라이트 방송분을 끝으로 종영되었고, 후속 프로그램으로 배우  << _obj_ >> 가 진행하는 토크쇼  << _sbj_ >> 가 방송되었다.
마리오_괴체	보루시아_도르트문트	team	 13라운드  << _obj_ >> 와의 더비 경기에서 카가와 신지의 1대1 상황에서의 칩샷을 재빠른 상황판단으로 선방해내는등 좋은 모습을 보여줬으나 경기 막판  << _sbj_ >> 에게 다소 불운한 실점을 하며 1대 0으로 패하고 만다.
린다_맥마흔	스테퍼니_맥마흔	child	가족은 아버지 빈스 맥마흔과 어머니  << _sbj_ >> , 여동생  << _obj_ >> 이 있고, 트리플 H의 처남이기도 하다.
나미브_사막	앙골라	country	 웰위치아는 지리적으로 나미비아와  << _obj_ >> 의  << _sbj_ >> 에만 제한적으로 자생한다.
비렌드라	디펜드라	child	조사 결과에 의하면,  << _obj_ >>  왕자가 취한 채 손님들과 함께 버릇 없이 행동하였고, 그 결과로 그의 아버지인  << _sbj_ >>  왕, 그의 아들은 만찬회장을 떠났다.
비렌드라	디펜드라	successor	조사 결과에 의하면,  << _obj_ >>  왕자가 취한 채 손님들과 함께 버릇 없이 행동하였고, 그 결과로 그의 아버지인  << _sbj_ >>  왕, 그의 아들은 만찬회장을 떠났다.
피오렌티노	산마리노	country	소시에타 폴리스포르티바 트레 피오리, 약칭 SP 트레 피오리는  << _obj_ >>   << _sbj_ >> 의 축구 클럽으로, 현재 산마리노 풋볼챔피언십 소속으로 활동하고 있다.
말할_수_없는_비밀	저우제룬	starring	  << _obj_ >>  감독의 영화 《 << _sbj_ >> 》에서 청의 역을 맡아 그해 금마장 여우조연상 후보에 올랐다.
말할_수_없는_비밀	저우제룬	director	  << _obj_ >>  감독의 영화 《 << _sbj_ >> 》에서 청의 역을 맡아 그해 금마장 여우조연상 후보에 올랐다.
시스코_(축구_선수)	뉴캐슬_유나이티드_FC	team	 또한 전  << _obj_ >> 의 공격수  << _sbj_ >> 를 영입하기도 했다.
안드레스_과르다도	발렌시아_CF	team	발레론은 2008년 1월 27일  << _obj_ >> 와의 홈 경기에서  << _sbj_ >> 와 교체되며 133일만에 출장하였으며, 그 경기에서 15분 동안 활약하며 팀의 2-1 승리에 기여하였다.
태창제	천계제	successor	 이듬해인 1620년은 만력제가 죽고,  << _sbj_ >> 가 즉위했으나 9월 26일 재위 29일만에 신하에게 독살당해  << _obj_ >> 가 즉위하였다.
샹피오나_드_프랑스_아마퇴르	프랑스	country	AC 아를 아비뇽은  << _obj_ >>  아비뇽의 축구 클럽으로, 현재  << _sbj_ >>  소속으로 활동하고 있다.
윤두수	윤방	child	 그의 가계는 윤근수,  << _sbj_ >>  형제가 집안을 일으킨 뒤 5대조 윤두수, 종5대조 윤근수, 종고조부  << _obj_ >> 이 모두 공신으로 부원군의 봉작을 받았다.
킹스턴_(자메이카)	자메이카	country	패트릭 유잉은 1962년  << _obj_ >>   << _sbj_ >> 에서 태어났는데, 어린 시절 크리켓과 축구에서 두각을 보였다.
성냥팔이_소녀의_재림	대한민국	country	 2002년에는  << _obj_ >>  영화  << _sbj_ >> 에도 출연하였다.
바이막스키_군	러시아	country	시바이는  << _obj_ >>  바시키르 공화국  << _sbj_ >> 에 속한 도시이다.
투쿠만_주	아르헨티나	country	소사는 1935년 7월 9일  << _obj_ >>   << _sbj_ >>  산미겔데투쿠만에서 태어났다.
랑드_주	프랑스	country	 아르마냐크는 현재  << _obj_ >>  남서쪽의 제르 주,  << _sbj_ >> , 로트에가론 주를 포함하는 지역이며, 14세기와 15세기동안 최대의 영향력을 발휘하며 영토를 확장하였다.
한국여자프로농구	인천_신한은행_에스버드	team	2015년 03월:  << _sbj_ >>  정규시즌 3위, 플레이오프 對 << _obj_ >>  승리, 챔피언 결정전 對아산 우리은행 위비 준우승
구창모_(야구_선수)	NC_다이노스	team	 이 후 경기인  << _obj_ >> 와의 경기에서도  << _sbj_ >> 와 영건 선발 투수 대결에서 7이닝 무실점 4탈삼진으로 2경기 연속 퀄리티스타트+를 기록하였다.
루이장	브라질_축구_국가대표팀	team	 2002년 6월 3일 울산시에서 열린  << _obj_ >> 과의 2002년 FIFA 월드컵 조별 예선 첫 경기에서는  << _sbj_ >> 의 유니폼을 잡고 늘어져 넘어뜨려 페널티킥을 허용하였고, 팀은 1-2로 패하였다.
미키의_크리스마스_선물	루시_테일러	starring	초기는 토니 안셀모. 욕심쟁이 오리아저씨에서는  << _obj_ >> ,  << _sbj_ >> 에서는 트레스 맥네일이 연기했다.
아메리칸_리그	캔자스시티_로열스	team	  << _obj_ >>  시절인 2009년에  << _sbj_ >>  사이 영 상을 수상했다.
사조영웅전	홍콩	country	동성서취는 1993년  << _obj_ >> 에서 개봉한 영화로, 김용의 소설  << _sbj_ >> 을 원작으로하는 코미디 영화이다.
마르크비비앙_푀	카메룬_축구_국가대표팀	team	이 경기장에서 열린 2003년 FIFA 컨페더레이션스컵 준결승전  << _obj_ >> 과 콜롬비아 축구 국가대표팀와의 경기에서 카메룬의 미드필더  << _sbj_ >> 가 후반 30분경 갑자기 쓰러져 사망하였다.
김두현_(축구_선수)	대한민국_축구_국가대표팀	team	2011 시즌을 앞두고는  << _obj_ >>  출신의  << _sbj_ >> 이 입대하면서 큰 관심을 받았다.
옐로스톤_강	미국	country	옐로스톤 폭포은  << _obj_ >> 의 옐로스톤 국립공원에 있는  << _sbj_ >> 의 두 폭포이다.
폴리스_스토리	성룡	starring	1985년  << _sbj_ >>   :  << _obj_ >> , 장만옥
폴리스_스토리	성룡	starring	 배우 브루스 리,  << _obj_ >> , 홍금보, 원표 등을 거느렸으며, 그동안 프로젝트 A,  << _sbj_ >> , 홍번구 등 600여 편의 액션 영화를 제작하여 1970-1980년대 홍콩 영화계를 상징한 영화사였다.
폴리스_스토리	성룡	director	1985년  << _sbj_ >>   :  << _obj_ >> , 장만옥
폴리스_스토리	성룡	director	 배우 브루스 리,  << _obj_ >> , 홍금보, 원표 등을 거느렸으며, 그동안 프로젝트 A,  << _sbj_ >> , 홍번구 등 600여 편의 액션 영화를 제작하여 1970-1980년대 홍콩 영화계를 상징한 영화사였다.
중경삼림	왕페이	starring	1994년  << _sbj_ >>   : 양조위, 가네시로 다케시,  << _obj_ >> , 주가령
트라야누스	하드리아누스	successor	 콰발라 보물은 오토 , 베스파시아누스,  << _sbj_ >> ,  << _obj_ >> 의 데나리를 드러냈다.
마토_네레틀랴크	오미야_아르디자	team	 2011년  << _sbj_ >> 의 대체자를 찾던  << _obj_ >> 의 눈에 띄어 오미야로 이적하였고 2시즌 간 활약하였다.
미로슬라프_클로제	FC_바이에른_뮌헨	team	 마카이가 바이에른 뮌헨을 떠나는 결정을 한 데에는  << _obj_ >> 의 루카 토니,  << _sbj_ >>  영입의 영향이 컸다.
신영준	포항_스틸러스	team	2013년 6월 11일 전남 드래곤즈는  << _sbj_ >> 을  << _obj_ >> 에 보내며 그를 데려오는 1-1 맞트레이드를 단행하였다.
보덴_호	스위스	country	콘스탄츠는 독일 남쪽  << _sbj_ >> 에 위치한 도시로, 보덴 호와 맑은 날에는 바로  << _obj_ >> 의 알프스 산맥가 보여 관광지로 유명한 도시이다.
성균관대학교	대한민국	country	유홍준은 1949년에  << _obj_ >>  서울에서 태어났으며 서울대학교 문리과대학 미학과를 졸업하고 홍익대학교 대학원 미술사학 석사과정을 마쳤으며  << _sbj_ >>  대학원 예술철학 박사과정을 수료하였다.
정병탁	대한민국_축구_국가대표팀	team	 1995년 시즌 도중  << _obj_ >>  감독에 선임되었고 이듬 해인 1996년 6월  << _sbj_ >>  감독이 사임한 전남 드래곤즈의 감독으로 취임하며 K리그에 복귀하였다.
잘랄아바트	키르기스스탄	country	잘랄아바트 주는  << _obj_ >> 의 주로, 주도는  << _sbj_ >> 이며 북쪽에서 시계 방향으로 탈라스 주, 추이 주, 나린 주, 오시 주, 우즈베키스탄과 인접해 있다.
박윤화	경남_FC	team	2008년 상반기에  << _obj_ >> 로 이적하여 리그컵 2008 1경기에 출장하였으나, 반 시즌 만에  << _sbj_ >> 와의 맞트레이드 형식으로 포항 스틸러스로 다시 복귀하였다.
선더베이	캐나다	country	선더베이 칠는  << _obj_ >>  온타리오 주  << _sbj_ >> 를 연고지로 하는 아마추어 축구팀이다.
2010_FA_커뮤니티_실드	첼시_FC	team	에르난데스가 치른 첫 경기는 8월 8일,  << _obj_ >> 와의  << _sbj_ >> 로, 유나이티드의 2번째 골을 기록해 3-1 승리에 일조했다.
도쿠가와_이에시게	도쿠가와_이에하루	successor	 그 후에도  << _sbj_ >> 와  << _obj_ >>  2대에 걸쳐 공적을 거두었다.
아르다시르_3세	샤흐르바라즈	successor	푸란도흐트는  << _sbj_ >> 를 살해한  << _obj_ >> 를 죽이고 왕위에 올랐다.
펠리페_6세	아스투리아스_여공_레오노르	child	스페인의 현재 국왕은 부르봉 왕가의  << _sbj_ >> 이며, 왕위 계승 순위 1위는 펠리페 6세의 장녀  << _obj_ >> 이다.
펠리페_6세	아스투리아스_여공_레오노르	child	   << _obj_ >>  ,  << _sbj_ >> 의 딸.
펠리페_6세	아스투리아스_여공_레오노르	child	처음으로 아스투리아스 공이라 불린 사람은 카스티야의 엔리케 3세였으며, 현재 이 직함을 갖고 있는 사람은  << _obj_ >> 으로, 2014년 6월 19일, 아버지인  << _sbj_ >> 의 왕령에 의해 이 명칭에 봉해졌다.
펠리페_6세	아스투리아스_여공_레오노르	successor	스페인의 현재 국왕은 부르봉 왕가의  << _sbj_ >> 이며, 왕위 계승 순위 1위는 펠리페 6세의 장녀  << _obj_ >> 이다.
펠리페_6세	아스투리아스_여공_레오노르	successor	   << _obj_ >>  ,  << _sbj_ >> 의 딸.
펠리페_6세	아스투리아스_여공_레오노르	successor	처음으로 아스투리아스 공이라 불린 사람은 카스티야의 엔리케 3세였으며, 현재 이 직함을 갖고 있는 사람은  << _obj_ >> 으로, 2014년 6월 19일, 아버지인  << _sbj_ >> 의 왕령에 의해 이 명칭에 봉해졌다.
부에노스아이레스_주	아르헨티나	country	바이아블랑카는  << _obj_ >> 의  << _sbj_ >>  최남단에 위치한 항구 도시이다.
무함마드_다우드	누르_무함마드_타라키	successor	 그리고 아프가니스탄 인민 민주당에 합류해 1978년 4월 27일 바브락 카르말,  << _obj_ >>  등과 함께 쿠데타를 일으켜 대통령  << _sbj_ >> 를 살해했다.
곤살로_카스트로	보루시아_도르트문트	team	  << _obj_ >> 와의 15라운드 경기에서 전반 18분  << _sbj_ >> 의 패스를 받아 골키퍼를 제치고 왼발로 선제골이자 결승골인 리그 7호 골을 기록해 팀의 1:0 승리를 이끌었다.
베로나_현	이탈리아	country	마시모 모라티는  << _obj_ >>   << _sbj_ >> 에서 가까운 베네토 주 보스코키에사누오바에서 안젤로 모라티의 넷째 아들로 태어났다.
황제를_위하여_(영화)	박성웅	starring	 같은 해 6월 개봉한 영화 《 << _sbj_ >> 》에서는 이민기,  << _obj_ >> 과 함께 출연해 룸살롱 마담 차연수를 연기했다.
플레이하우스_디즈니	디즈니_주니어	successor	 2009년 4월 4일부터 디즈니 채널의 블록편성 시간대인  << _sbj_ >> 를 통해 방송되었으나, 2011년 7월 11일부터  << _obj_ >> 에서 옮겨 방송되었다.
UEFA_챔피언스리그_2007-08	첼시_FC	team	 그는  << _sbj_ >> 에서 7경기를 출장했고,  << _obj_ >> 와의 조별 예선 경기에서는 팀의 미드필드에서 강하고 인상적인 활약을 보이기도 했다.
호르미즈드_1세	바흐람_1세	successor	 아버지는 샤푸르 1세이며,  << _sbj_ >> 와  << _obj_ >> 의 동생이다.
디오클레티아누스	갈레리우스	successor	 당시의 로마 제국은  << _sbj_ >> 와 그의 양자  << _obj_ >> 의 치세였다.
안토니오_디_나탈레	우디네세_칼초	team	 카바니는 리그를 23득점으로 마무리하였고,  << _obj_ >> 와 이탈리아 축구 국가대표팀 스트라이커  << _sbj_ >> 와 함께 공동 3위에 랭크되었다.
잭_더_자이언트_킬러	브라이언_싱어	director	2013년, 홀트는 동화 책 "잭과 콩나무"를 모티프로, 거인과 인간의 대결을 그린  << _obj_ >>  감독의 블록버스터 영화 《 << _sbj_ >> 》에서 주연 '잭' 역할을 연기했고, 같은 해 개봉 된 아이작 마리온의 베스트셀러를 영화화한 좀비 로맨스 영화 《웜 바디스》에서는 주연 'R' 역할을 맡아 사랑에 빠진 좀비라는 독특한 설정의 이야기로 인간과 좀비 사이에서 갈등하며 조금씩 인간성을 찾아가는 과정을 유머러스하면서도 쿨하게 연기했다.
롤란도_폰세카	코스타리카_축구_국가대표팀	team	파울로 세사르 완초페 와트손 은 은퇴한 코스타리카의 축구 선수이며, 선수 시절  << _obj_ >> 에서 73번의 국가대표 경기에 출전하여 45골을 득점했고,  << _sbj_ >>  다음으로 국가대표팀에서 많은 득점을 한 선수가 되었다.
주세페_메아차	아탈란타_BC	team	 그의 마지막 경기는 5월 31일  << _sbj_ >> 에서  << _obj_ >> 와의 리그 마지막 경기였다.
맥도넬더글러스_DC-9	맥도넬더글러스_MD-80	successor	 재취항 당시 재팬 에어 시스템이  << _obj_ >> 과  << _sbj_ >>  기종으로 도쿄 국제공항, 신치토세 공항, 오사카 국제공항을 잇는 국내선 노선을 운항하기 시작했다.
드니프로	우크라이나	country	드니프로페트로우스크 주는  << _obj_ >>  중부에 위치한 주로 주도는  << _sbj_ >> 이며 면적은 31,914㎢, 인구는 3,374,200명이다.
이반_클라스니치	SV_베르더_브레멘	team	2004-05 시즌, 그의 걸출한 활약을 주목한 독일 분데스리가의  << _obj_ >> 으로 이적하여 기대를 모았으나, 미로슬라프 클로제,  << _sbj_ >>  등에 밀려 주전 자리를 확보하지 못했다.
1978년_FIFA_월드컵_결승전	아르헨티나_축구_국가대표팀	team	 네덜란드는 이전에 2번 준우승을 거두었는데, 1974년 FIFA 월드컵 결승전에서는 독일 축구 국가대표팀에게 1-2로 패하였고,  << _sbj_ >> 에서는  << _obj_ >> 에게 연장전 끝에 1-3으로 패하였다.
1954년_FIFA_월드컵_결승전	헝가리_축구_국가대표팀	team	 결승전 진출국의 점수를 합치면 4211점으로, 종전에  << _obj_ >> 와 독일 축구 국가대표팀간의  << _sbj_ >> 에 기록한 도합 4161점을 넘어 세계 축구 엘로 랭킹#최고 가치의 경기들로 기록되었다.
맬컴_글레이저	조엘_글레이저	child	현재 동생  << _obj_ >> 와 아버지  << _sbj_ >> 와 함께 잉글랜드 프리미어리그의 맨체스터 유나이티드 FC의 공동 회장으로 취임하였으며, 석유 기업 자파타 코퍼레이션과 오메카 프로테인 코퍼레이션의 최고 경영자이기도 하다.
나콘나욕_주	타이	country	나콘나욕은  << _obj_ >> 의 읍이자  << _sbj_ >> 의 주도이다.
깐짜나부리_주	타이	country	깐짜나부리는  << _obj_ >>  서부의 읍이자  << _sbj_ >> 의 수도이다.
하메스_로드리게스	콜롬비아_축구_국가대표팀	team	 우루과이는 디에고 고딘의 결승골에 힘입어 1:0으로 이기고 16강 진출에 성공했지만, 16강전에서 수아레스가 빠진 상태로  << _obj_ >> 를 상대하여  << _sbj_ >> 에게 2골을 내주고 0:2로 져 8강 진출에 실패했다.
어쿠스틱_(영화)	강민혁_(가수)	starring	 2010년 가을에는 영화 《 << _sbj_ >> 》에  << _obj_ >> 과 함께 출연하며 연기에 도전하기도 했다.
조병옥	조순형	child	  << _sbj_ >> 의 아들이며  << _obj_ >> 의 형이다.
온병훈	숭실대학교	team	  << _obj_ >> 에서 김영후, 박주호, 양상민,  << _sbj_ >> , 고무열 등의 선수들을 발굴했다.
유젠왕_구	홍콩	country	웡걱는  << _obj_ >> 의 주룽 북부의  << _sbj_ >> 에 있는 번화가를 가리킨다.
손원일	대한민국_해군	country	 아들은 훗날  << _obj_ >>  창군 주역이자 해군 제독으로 지낸  << _sbj_ >> 이다.
FIFA_클럽_월드컵_2008	리가_데포르티바_우니베르시타리아_데_키토	team	 2004년 AFC 아시안컵에서는 아랍에미리트와 대한민국의 조별 예선 경기의 주심을 맡았으며 2007년 FIFA U-20 월드컵에서는 감비아와 멕시코, 칠레와 콩고 공화국의 조별 예선 두 경기, 미국과 우루과이의 16강전 경기, 스페인과 체코의 8강전 경기의 주심을 맡았고  << _sbj_ >> 에서는 알아흘리 와 CF 파추카의 8강전 경기,  << _obj_ >> 와 맨체스터 유나이티드 FC의 결승전 경기의 주심을 맡았다.
야말로네네츠_자치구	러시아	country	만의 주위는  << _obj_ >> 의  << _sbj_ >> 이고, 만의 서쪽은 야말 반도, 동쪽은 구이단 반도, 타좁스키 반도에서 타즈 강이 흘러 들어가는 타좁스키 만이 있다.
헤이다르_알리예프	일함_알리예프	child	  << _sbj_ >>  대통령의 아들  << _obj_ >> 가 아르투르 라시자데의 뒤를 이어 총리에 취임했다.
헤이다르_알리예프	일함_알리예프	successor	  << _sbj_ >>  대통령의 아들  << _obj_ >> 가 아르투르 라시자데의 뒤를 이어 총리에 취임했다.
대한민국_제6회_지방_선거	대한민국	country	이재명은  << _obj_ >> 의 변호사, 시민운동가이자 대한민국 제5회 지방 선거· << _sbj_ >>  경기도 성남시장이자 성남 FC의 구단주이다.
이시카와_마사노리	도쿄_야쿠르트_스왈로스	team	 팀내 유일한 두 자릿수 승리를 거두어  << _obj_ >> 의 투수인  << _sbj_ >> 와의 신인왕을 놓고 경쟁을 했다.
트위크넘	영국	country	트위크넘 스타디움은 1907년 완공되어 1909년 운영을 시작한  << _obj_ >>  런던  << _sbj_ >> 의 럭비 경기장이다.
달세계_여행	조르주_멜리에스	starring	이 장르는 무성 영화 초기부터 존재했고,  << _obj_ >> 가 특수 효과 효과를 이용한 《 << _sbj_ >> 》이 그 시초로 알려져있다.
달세계_여행	조르주_멜리에스	starring	 영화의 1902년,  << _obj_ >> 가 일반적으로 최초의 SF 영화로 여겨지는 《 << _sbj_ >> 》을 발표했고, 이것은 우주선의 달 여행을 묘사하기 위해 초기의 특수 효과 기법을 이용한 영화이다.
달세계_여행	조르주_멜리에스	director	이 장르는 무성 영화 초기부터 존재했고,  << _obj_ >> 가 특수 효과 효과를 이용한 《 << _sbj_ >> 》이 그 시초로 알려져있다.
달세계_여행	조르주_멜리에스	director	 영화의 1902년,  << _obj_ >> 가 일반적으로 최초의 SF 영화로 여겨지는 《 << _sbj_ >> 》을 발표했고, 이것은 우주선의 달 여행을 묘사하기 위해 초기의 특수 효과 기법을 이용한 영화이다.
내셔널_하키_리그	피츠버그_펭귄스	team	 1984년부터 미국과 캐나다의 마이너리그에서 뛰었고, 1985년  << _sbj_ >>  팀인  << _obj_ >>  드래프트로 지명되었다.
클로타르_2세	하리베르트_2세	successor	 프랑크 왕국  << _sbj_ >> 의 손자이자 바스크 족에게 암살당한  << _obj_ >> 의 아들로 어머니는 불확실하다.
소네_아라스케	데라우치_마사타케	successor	 이러한 때에 이토 히로부미가 통감에서 물러나고, 부통감인  << _sbj_ >> 가 통감이 되었다가 무능하다 하여 곧 물러나게 하고, 이듬해 5월  << _obj_ >> 가 통감이 되었다.
에드워드_2세	에드워드_3세	child	  << _sbj_ >> 가 죽자 그의 왕비 프랑스의 이사벨라와 함께 어린  << _obj_ >> 의 섭정이 되었다.
에드워드_2세	에드워드_3세	child	잉글랜드왕  << _sbj_ >> 와 결혼한 누나 프랑스의 이사벨라이 유약하고 국민들에게 인기가 없는 남편에게 염증을 느껴 를 끌어들여 1326년에 반란을 일으키자, 샤를 4세는 이자벨을 지원했고, 이에 힘입어 이자벨은 에드워드 2세를 제압하고 아들인  << _obj_ >> 를 왕으로 옹립한다.
에드워드_2세	에드워드_3세	child	 존 오브 곤트와 랭커스터의 블랑슈는 8촌 남매간인데, 존은 헨리 3세의 아들 에드워드 1세의 증손자로, 에드워드 1세- << _sbj_ >> - << _obj_ >> -존으로 이어졌으며, 블랑슈는 헨리 3세의 다른 아들 곱사등이 에드먼드의 증손녀로 헨리 3세-곱사등이 에드먼드-헨리-헨리 그로스몬트-블랑슈로 이어졌다.
에드워드_2세	에드워드_3세	successor	  << _sbj_ >> 가 죽자 그의 왕비 프랑스의 이사벨라와 함께 어린  << _obj_ >> 의 섭정이 되었다.
에드워드_2세	에드워드_3세	successor	잉글랜드왕  << _sbj_ >> 와 결혼한 누나 프랑스의 이사벨라이 유약하고 국민들에게 인기가 없는 남편에게 염증을 느껴 를 끌어들여 1326년에 반란을 일으키자, 샤를 4세는 이자벨을 지원했고, 이에 힘입어 이자벨은 에드워드 2세를 제압하고 아들인  << _obj_ >> 를 왕으로 옹립한다.
에드워드_2세	에드워드_3세	successor	 존 오브 곤트와 랭커스터의 블랑슈는 8촌 남매간인데, 존은 헨리 3세의 아들 에드워드 1세의 증손자로, 에드워드 1세- << _sbj_ >> - << _obj_ >> -존으로 이어졌으며, 블랑슈는 헨리 3세의 다른 아들 곱사등이 에드먼드의 증손녀로 헨리 3세-곱사등이 에드먼드-헨리-헨리 그로스몬트-블랑슈로 이어졌다.
에드워드_5세	리처드_3세	successor	형인  << _sbj_ >> 와 함께 숙부  << _obj_ >> 가 정변을 일으켰을 때, 청동탑에 감금되었다가 살해되었다.
헨리_4세	헨리_5세	child	랭커스터 왕가의  << _sbj_ >> 는 그의 아들이었고,  << _obj_ >> , 헨리 6세, 에드워드 랭커스터는 각각 그의 손자, 증손, 고손이 된다.
헨리_4세	헨리_5세	child	 에드워드 웨스트민스터는 존 오브 곤트- << _sbj_ >> - << _obj_ >> -헨리 6세-에드워드 웨스트민스터로 이어졌고, 앤 네빌은 존 오브 곤트-딸 조앤 뷰포트-리처드 네빌-리처드 네빌 2세-앤 네빌로, 서로 증대고모의 증손녀딸이자 증외종증조부의 증손자로서 서로 8촌간이 된다.
헨리_4세	헨리_5세	successor	랭커스터 왕가의  << _sbj_ >> 는 그의 아들이었고,  << _obj_ >> , 헨리 6세, 에드워드 랭커스터는 각각 그의 손자, 증손, 고손이 된다.
헨리_4세	헨리_5세	successor	 에드워드 웨스트민스터는 존 오브 곤트- << _sbj_ >> - << _obj_ >> -헨리 6세-에드워드 웨스트민스터로 이어졌고, 앤 네빌은 존 오브 곤트-딸 조앤 뷰포트-리처드 네빌-리처드 네빌 2세-앤 네빌로, 서로 증대고모의 증손녀딸이자 증외종증조부의 증손자로서 서로 8촌간이 된다.
헨리_5세	헨리_6세	child	랭커스터 왕가의 헨리 4세는 그의 아들이었고,  << _sbj_ >> ,  << _obj_ >> , 에드워드 랭커스터는 각각 그의 손자, 증손, 고손이 된다.
헨리_5세	헨리_6세	child	  << _sbj_ >> 가 사망한 뒤 그의 왕비였던 발루아의 캐서린이 오웬 튜더와 재혼하여 낳은 아들이었던 에드먼드 튜더는  << _obj_ >> 의 씨다른 동생이다.
헨리_5세	헨리_6세	child	 에드워드 웨스트민스터는 존 오브 곤트-헨리 4세- << _sbj_ >> - << _obj_ >> -에드워드 웨스트민스터로 이어졌고, 앤 네빌은 존 오브 곤트-딸 조앤 뷰포트-리처드 네빌-리처드 네빌 2세-앤 네빌로, 서로 증대고모의 증손녀딸이자 증외종증조부의 증손자로서 서로 8촌간이 된다.
헨리_5세	헨리_6세	child	옛 웨일스 공의 후예였지만 하급 귀족으로 전락한 오언 튜더와  << _sbj_ >> 의 과부였던 발루아의 캐서린이 결혼함에 따라, 두 사람 사이에 태어난 아이들은 일약  << _obj_ >> 의 이부동복 동생이 됨과 동시에 발루아 왕가의 혈통을 이어받게 됨으로써 상급 귀족의 일원이 되었다.
헨리_5세	헨리_6세	successor	랭커스터 왕가의 헨리 4세는 그의 아들이었고,  << _sbj_ >> ,  << _obj_ >> , 에드워드 랭커스터는 각각 그의 손자, 증손, 고손이 된다.
헨리_5세	헨리_6세	successor	  << _sbj_ >> 가 사망한 뒤 그의 왕비였던 발루아의 캐서린이 오웬 튜더와 재혼하여 낳은 아들이었던 에드먼드 튜더는  << _obj_ >> 의 씨다른 동생이다.
헨리_5세	헨리_6세	successor	 에드워드 웨스트민스터는 존 오브 곤트-헨리 4세- << _sbj_ >> - << _obj_ >> -에드워드 웨스트민스터로 이어졌고, 앤 네빌은 존 오브 곤트-딸 조앤 뷰포트-리처드 네빌-리처드 네빌 2세-앤 네빌로, 서로 증대고모의 증손녀딸이자 증외종증조부의 증손자로서 서로 8촌간이 된다.
헨리_5세	헨리_6세	successor	옛 웨일스 공의 후예였지만 하급 귀족으로 전락한 오언 튜더와  << _sbj_ >> 의 과부였던 발루아의 캐서린이 결혼함에 따라, 두 사람 사이에 태어난 아이들은 일약  << _obj_ >> 의 이부동복 동생이 됨과 동시에 발루아 왕가의 혈통을 이어받게 됨으로써 상급 귀족의 일원이 되었다.
주간_영_선데이	일본	country	《소라닌》은  << _obj_ >> 의 청년 만화잡지 《 << _sbj_ >> 》에 2005년에서 2006년까지 연재된, 아사노 이니오의 청년만화 작품이다.
FIFA_클럽_월드컵_2007	AC_밀란	team	 이후 2006년 FIFA 월드컵에서 잉글랜드와 파라과이, 코트디부아르와 세르비아 몬테네그로의 조별 예선 두 경기의 주심을 맡았으며,  << _sbj_ >> 에서 세파한 FC과 와이타케레 유나이티드의 플레이오프 경기, 보카 주니어스와  << _obj_ >> 의 결승전 경기의 주심을 맡았다.
하우_투_루즈_프렌즈	커스틴_던스트	starring	 같은 해 6월 제프 브리지스, 사이먼 페그,  << _obj_ >> 와 함께 《 << _sbj_ >> 》에 소피 매스 역으로 출연 했으나, 박스오피스 흥행 실패로 끝났다.
발테르_야콥손	핀란드	country	 1910년 세계 피겨 스케이팅 선수권 대회에서  << _obj_ >>  출신의 파트너  << _sbj_ >> 과 함께 페어 부문에서 2위에 올랐다.
한국_광복군	대한민국_임시_정부	country	 1919년 3·1 운동을 기점으로 구성된  << _obj_ >> 는 이후 중일 전쟁 동안 중국 국민당과 연합하여 독립운동을 통한 방식으로 대일항쟁을 시작하는 한편, 진주만 공격이 있었던 1941년에는  << _sbj_ >> 을 창설해 추축국인 일본 제국과 나치 독일에 선전포고하고 1944년에는 버마 전선에서 영국군의 요청으로 임팔 전투에 광복군 요원을 투입하여 전쟁에 참여한다.
이토이_요시오	오릭스_버펄로스	team	1월 25일 팀동료인  << _sbj_ >> 와 함께 기사누키 히로시, 아카다 쇼고, 오비키 게이지를 상대로  << _obj_ >> 에 트레이드 되어 이적했다.
체이싱_아미	케빈_스미스	starring	 그는 이후 성년 코미디 《멍하고 혼돈스러운》와  << _obj_ >>  감독의 《몰래츠》, 《 << _sbj_ >> 》와 《도그마 》를 포함한 여러 영화에 출연하였다.
체이싱_아미	케빈_스미스	starring	 그는 협박하는 연기를 한 코미디 《몰래츠》에서 각본가 겸 감독인  << _obj_ >> 와 촬영하는 동안 친구가 되었고, 스미스의 로맨틱 코미디 《 << _sbj_ >> 》에서 애플렉은 주연을 맡았다.
체이싱_아미	케빈_스미스	starring	 그는  << _obj_ >>  감독의 《 << _sbj_ >> 》에서 만화가를 연기해 예술적인 성공을 하였고, 맷 데이먼과 함께 각본을 쓴 드라마 영화 《굿 윌 헌팅》으로 아카데미 각본상과 골든 글로브 각본상을 수상하였다.
체이싱_아미	케빈_스미스	director	 그는 이후 성년 코미디 《멍하고 혼돈스러운》와  << _obj_ >>  감독의 《몰래츠》, 《 << _sbj_ >> 》와 《도그마 》를 포함한 여러 영화에 출연하였다.
체이싱_아미	케빈_스미스	director	 그는 협박하는 연기를 한 코미디 《몰래츠》에서 각본가 겸 감독인  << _obj_ >> 와 촬영하는 동안 친구가 되었고, 스미스의 로맨틱 코미디 《 << _sbj_ >> 》에서 애플렉은 주연을 맡았다.
체이싱_아미	케빈_스미스	director	 그는  << _obj_ >>  감독의 《 << _sbj_ >> 》에서 만화가를 연기해 예술적인 성공을 하였고, 맷 데이먼과 함께 각본을 쓴 드라마 영화 《굿 윌 헌팅》으로 아카데미 각본상과 골든 글로브 각본상을 수상하였다.
멍하고_혼돈스러운	리처드_링클레이터	director	 이 기간동안 애플렉이 가장 주목할만한 작품으로는  << _obj_ >>  감독의 컬트 클래식 《 << _sbj_ >> 》으로 이 영화에서 불량학생으로 출연하였다.
그는_당신에게_반하지_않았다_(영화)	제니퍼_애니스턴	starring	 앙상블 로맨틱 코미디 《 << _sbj_ >> 》에서 애플렉은  << _obj_ >> 과 연인 사이를 연기하였고, 영화는 주로 평이 갈렸지만, 전세계 흥행 수입은 1억 6,500만 달러로 흥행하였다.
리추_천황	한제이_천황	successor	 어머니는 가쓰라기노 소쓰히코의 딸인 이와노히메노미코토이며,  << _sbj_ >> ,  << _obj_ >> 의 친동생이다.
히카르두_페레이라	포르투갈_축구_국가대표팀	team	 그리고  << _obj_ >> 과의 8강전 승부차기에서 잉글랜드의 첫 번째 키커로 나섰지만 상대 골키퍼  << _sbj_ >> 에 막혔다.
무단_강	중국	country	징푸 호는  << _obj_ >>  헤이룽장 성 닝안 시의 완다 산맥에 있는  << _sbj_ >>  상류에 위치한 호수이다.
레흐_카친스키	브로니스와프_코모로프스키	successor	  << _obj_ >>  하원의장은 8개월 뒤에 대선에 출마하여, 4년 재선을 노리는  << _sbj_ >>  대통령과 경쟁할 예정이었다.
고토바_천황	쓰치미카도_천황	successor	어릴 때부터 재기가 풍부해, 1200년 4월에 황태자가 되었고 1210년 11월,  << _sbj_ >> 의 강한 의향에 의해  << _obj_ >> 의 양위를 받아 즉위하였다.
대부_2	프랜시스_포드_코폴라	director	조니 올라 는  << _obj_ >>  감독이 제작한 《 << _sbj_ >> 》에 등장하는 인물 중 하나로 하이먼 로스의 심복으로 등장한다.
로스트	테리_오퀸	starring	조너선 "존" 로크 John Locke 는 미국의 방송국 ABC 의 텔레비전 드라마 시리즈  << _sbj_ >> 의 등장인물로  << _obj_ >> 이 연기를 맡았다.
아니에르쉬르센	프랑스	country	 1900년 8월 11일부터 19일까지  << _obj_ >>  파리  북서쪽 교외에 있는  << _sbj_ >> 을 흐르는 센 강에서 진행되었다.
우크라이나_프리미어리그	우크라이나	country	안드리 올렉시요비치 보로베이  는  << _obj_ >> 의 축구 선수로, 포지션은 공격수이며,  << _sbj_ >> 의 FC 아르세날 키예프  소속이다.
유대인_자치주	러시아	country	비로비잔는  << _obj_ >>   << _sbj_ >> 의 주청 소재지이며, 비로비잔스키 군과 행정적으로는 분리되어 있으나 그 군청이 소재한다.
다카하라_나오히로	아인트라흐트_프랑크푸르트	team	 이전 함부르크 SV,  << _obj_ >>  등 독일에서 활약하던  << _sbj_ >> 가 현재 가가와의 에이전트를 맡고 있는 토마스 크로트에게 "가가와 신지라는 좋은 선수가 있다" 라는 조언을 하는 것이 계기로, 도르트문트 행을 주도하고 있었다.
기아_카스타	기아_카렌스	successor	 전라북도 군산시 소룡동에서 생산됐으며, 당시 경쟁 차종으로는  << _sbj_ >> ,  << _obj_ >> , 현대 싼타모 등이 있었으며, 2000년에 대한민국 자동차 판매 순위 5위를 기록하였다.
오현택	두산_베어스	team	 시즌 후반기에 대주자나 대타로 나가면서 팀 득점에 도움을 줬고, 9월 24일  << _obj_ >>  투수  << _sbj_ >> 에게 번트로 프로 데뷔 첫 안타를 기록했다.
조평호	NC_다이노스	team	 2011년 11월 22일 2012년 KBO 리그 2차 드래프트에서  << _obj_ >> 에 지명되어 팀 동료  << _sbj_ >> 와 함께 NC 다이노스로 이적하게 된다.
덜루스_(조지아_주)	미국	country	존스크릭은  << _obj_ >>  조지아 주에 있는 도시이다<a href="http%3A//www.johnscreekga.gov"></a>. 인구의 급격한 증가에 따라  << _sbj_ >> , 알파레타 , 스와니  시의 경계 지역이 2006년 12월 새로운 시로 분리되었으며, 이름은 이 지역을 지나는 작은 강의 이름에서 유래하였다.
라이온_킹	네이선_레인	starring	 예를 들어  << _sbj_ >> 은 초호화 캐스팅으로 손꼽히는 작품 중 하나로,영화배우 매슈 브로더릭, 제러미 아이언스, 코믹배우 << _obj_ >> 등이 등장한다.
제임스_콜린스	애스턴_빌라_FC	team	 그는 11월 21일, 2-0으로 이긴  << _obj_ >> 와의 경기에서 토트넘 이적 후 4호, 5호골을 연달아 기록했는데, 첫 골은 머리를 넘겨 찬 골이었고, 두 번째 골은  << _sbj_ >>  애스턴 빌라 수비수의 실책을 처리한 것이었다.
매그놀리아_(영화)	톰_크루즈	starring	《 << _sbj_ >> 》 ,  << _obj_ >>  캐릭터가 버클리를 졸업했다고 거짓말을 한다.
당_경종	당_문종	successor	  << _sbj_ >> ,  << _obj_ >> 의 이복 동생이었다.
황금마차	임지은	starring	2002년 엄지원은 5월 개봉한 영화 《오버 더 레인보우 》에 작은 역할인 장진영의 직장 동료 김은송 역으로 출연한 후, 같은 해 7월부터 방송된 MBC 아침드라마 《 << _sbj_ >> 》에  << _obj_ >> 과 함께 주연으로 캐스팅되어 이복 언니인 임지은이 낳은 아들을 키우는 마음씨 착한 동생 황순정을 연기하며 처음으로 주요 배역을 맡게 되었다.
주홍글씨_(2004년_영화)	한석규	starring	이듬해인 2004년 엄지원은 SBS 드라마 《폭풍 속으로 》, 《매직 》에 출연했고, 10월 개봉한 영화 《 << _sbj_ >> 》에  << _obj_ >> , 이은주, 성현아와 같이 캐스팅되어 한석규의 아내인 첼리스트 한수현을 연기했다.
페스티발_(영화)	백진희	starring	 《스카우트 》 이후 다시 임창정과 같이 캐스팅되어 출연한 로맨틱 코미디 《불량남녀》에는 카드사 채권팀 직원 김무령으로 출연했고, 성을 소재로 한 코미디 《 << _sbj_ >> 》에는 신하균 , 심혜진, 성동일, 류승범,  << _obj_ >> , 오달수와 같이 캐스팅되어 신하균의 애인인 영어학원 강사 지수 역으로 출연했다.
정무문_(1972년_영화)	나유	director	《당산대형》과 《 << _sbj_ >> 》을 연달아 성공시킨  << _obj_ >>  감독과 결별한 뒤 이소룡이 직접 감독한 첫 작품이다.
오히라_마사요시	스즈키_젠코	successor	 1976년부터 1977년까지 후쿠다 다케오 내각의 후생장관, 1978년부터 1979년까지 제1차  << _sbj_ >>  내각의 농림수산대신, 1980년부터 1982년까지  << _obj_ >>  내각 및 개조 내각의 재무대신, 1985년부터 1986년까지 제2차 나카소네 야스히로 내각 제2차 개조 내각의 통산대신을 지냈다.
타이완_직업봉구_대연맹	중화민국	country	타이베이 타이양은  << _obj_ >> 에서 1997년부터 2002년까지  << _sbj_ >> 에 있었던 타이베이 시를 연고지로 한 팀이다.
와카쓰키_레이지로	다나카_기이치	successor	 행정법 전문가로 활약하며, 위생국장, 지방국장 등을 지냈으며, 1928년 내무차관이 되어,  << _obj_ >>  내각, 제2차  << _sbj_ >>  내각의 차관을 맡은 뒤, 1931년 귀족원 칙선 의원이 되었다.
세대공감_토요일	임백천	starring	본인의 선거운동 경력이 있었던 방송인  << _obj_ >> 을 2013년 4월 13일부터 KBS 2TV  << _sbj_ >>  새 MC로 발탁시켜 논란이 있었다.
아리랑_(1954년_영화)	이강천	director	《 << _sbj_ >> 》- 1954년 제작된  << _obj_ >>  감독의 영화
이터널_선샤인	짐_캐리	starring	이후  << _obj_ >> 와 함께 출연한 2004년 영화 《 << _sbj_ >>  》으로 제77회 아카데미 여우주연상에 지명되었다.
최운해	최윤덕	child	 인물로는 조선 초기의 장군인  << _sbj_ >> , 세종 때 4군을 개척하고 세종묘에 배향된  << _obj_ >> , 선조 때의 명문장가인 최립이 있다.
김성남_(축구인)	FC_서울	team	 친형은 전 울산 현대 감독인 김정남 이고 쌍둥이 동생  << _sbj_ >> 은  << _obj_ >> 의 2군 감독이다.
정_때문에	하희라	starring	한편, 스타급 캐스팅이 실패하는 바람에 정혜영을 주역으로 내세웠으며 정혜영은 <백조의 호수>에 앞서 출연한 일일극이면서 1998년 3월 종영된 KBS 1TV 일일극  << _sbj_ >>  이후 한동안 출산과 육아에 전념해 온 톱스타  << _obj_ >> 의 컴백작인 KBS 1TV 당신 옆이 좋아에서는 주인공 하희라의 여동생으로 나온 바 있었는데 이 작품은 <백조의 호수> 전작이면서 줄곧 조연급에 머물렀던 장서희를 주역으로 내세운 MBC 인어 아가씨 때문에 시청률 참패를 당했다.
에르난_크레스포	SS_라치오	team	 1999년, 시메오네는 스벤예란 에릭손의  << _obj_ >> 로 이적하며 동료 아르헨티나인들인 네스토르 센시니, 마티아스 알메이다,  << _sbj_ >> , 그리고 후안 세바스티안 베론과 합류하였다.
후안_세바스티안_베론	SS_라치오	team	 1999년, 시메오네는 스벤예란 에릭손의  << _obj_ >> 로 이적하며 동료 아르헨티나인들인 네스토르 센시니, 마티아스 알메이다, 에르난 크레스포, 그리고  << _sbj_ >> 과 합류하였다.
UEFA_유로파리그_2011-12	아틀레틱_빌바오	team	 2012년 5월 9일, 시메오네의 아틀레티코 마드리드는  << _obj_ >> 와의  << _sbj_ >>  결승전에서 3-0으로 이기며 우승을 차지하였다.
행복을_팝니다	김혜자	starring	 그 외에 김수현 작품에 단골 출연한 배우들로 《새엄마》, 《후회합니다》, 《 << _sbj_ >> 》, 《사랑의 굴레》, 《모래성 》, 《사랑이 뭐길래》, 《엄마가 뿔났다》 등 35년간 16번이나 호흡을 맞춘  << _obj_ >> 와, 《완전한 사랑》, 《부모님 전상서》, 《내 남자의 여자》 등 연거푸 김수현 작품에 출연한 김희애를 필두로, 이순재, 윤다훈, 정혜선, 강부자, 나문희, 전양자, 김영애 , 김해숙, 장미희, 임예진, 견미리, 하유미, 김나운 등이 있다.
엄마가_뿔났다	이순재	starring	 그 외에 김수현 작품에 단골 출연한 배우들로 《새엄마》, 《후회합니다》, 《행복을 팝니다》, 《사랑의 굴레》, 《모래성 》, 《사랑이 뭐길래》, 《 << _sbj_ >> 》 등 35년간 16번이나 호흡을 맞춘 김혜자와, 《완전한 사랑》, 《부모님 전상서》, 《내 남자의 여자》 등 연거푸 김수현 작품에 출연한 김희애를 필두로,  << _obj_ >> , 윤다훈, 정혜선, 강부자, 나문희, 전양자, 김영애 , 김해숙, 장미희, 임예진, 견미리, 하유미, 김나운 등이 있다.
내_남자의_여자	김희애	starring	 그 외에 김수현 작품에 단골 출연한 배우들로 《새엄마》, 《후회합니다》, 《행복을 팝니다》, 《사랑의 굴레》, 《모래성 》, 《사랑이 뭐길래》, 《엄마가 뿔났다》 등 35년간 16번이나 호흡을 맞춘 김혜자와, 《완전한 사랑》, 《부모님 전상서》, 《 << _sbj_ >> 》 등 연거푸 김수현 작품에 출연한  << _obj_ >> 를 필두로, 이순재, 윤다훈, 정혜선, 강부자, 나문희, 전양자, 김영애 , 김해숙, 장미희, 임예진, 견미리, 하유미, 김나운 등이 있다.
신의손	성남_FC	team	 설상가상으로 K리그 외국인 골키퍼 제한 조치로 인해 일화의 전설적인 골키퍼  << _sbj_ >> 의 출전도 점점 줄어들게 되어  << _obj_ >> 의 성적은 바닥으로 떨어질 수 밖에 없었다.
노르보텐	스웨덴	country	  << _obj_ >> 의  << _sbj_ >> 에서 가깝다.
아포칼립토	멜_깁슨	director	유카텍어는 영화배우 및 감독인  << _obj_ >> 이 감독 및 제작한  << _sbj_ >> 라는 영화의 대사로 쓰였다.
킬케니_주	아일랜드	country	킬케니는  << _obj_ >>  남부 내륙의  << _sbj_ >> 의 주도로 면적은 3.74㎢며 인구는 22,179명이다.
워터퍼드_주	아일랜드	country	워터퍼드는  << _obj_ >>  남부의  << _sbj_ >> 의 주도로 면적은 41.58㎢고 인구는 2006년기준 49,240명이다.
김익겸	김만중	child	 인경왕후의 조부이자 병자호란 때의 순절신  << _sbj_ >> 은 그의 형이며, 인경왕후의 친정아버지인 김만기 와 구운몽, 사씨남정기의 저자  << _obj_ >>  형제들은 그의 조카였다.
넬스프루이트	남아프리카_공화국	country	음푸말랑가 주는  << _obj_ >>  동부에 위치한 주로, 주도는  << _sbj_ >> 이다.
이스트앵글리아_대학교	영국	country	기후연구소 전자우편 논란 혹은 기후게이트는 2009년 11월  << _obj_ >>  잉글랜드 노르위치에 위치한  << _sbj_ >> 의 이스트앵글리아 기후연구소 컴퓨터 서버에 해킹으로 추정되는 비공식적인 누출로 인한 문서의 공개로 인한 파문을 일컫는다.
청사_(영화)	서극	director	 이 탑은 중국의 영화 감독인  << _obj_ >> 의 영화  << _sbj_ >> 의 소재 백사전의 전설이 깃든 것으로 널리 알려져 있다.
UEFA_챔피언스리그_2003-04	AS_모나코_FC	team	 여기에서 FC 포르투와  << _obj_ >> 간의  << _sbj_ >> 이 벌어졌고, FC 포르투가 AS 모나코 FC를 3-0으로 꺾고 두 번째 유러피언 컵을 들어올렸다.
젤랄_바야르	아드난_멘데레스	successor	 1950년에 이뇌뉘의 정당은 터키 역사상 첫 자유 선거에서 패배하였으며, 이뇌뉘는  << _sbj_ >> 와  << _obj_ >> 의 민주당 에 평화적으로 정권을 이양하였다.
로보캅	폴_버호벤	director	다음엔 1987년 《 << _sbj_ >> 》으로 헐리웃에서도 명성을 쌓은 네덜란드인  << _obj_ >> 을 영화 감독으로 기용하였다.
벨루노_현	이탈리아	country	코르티나담페초는  << _obj_ >>  북부의 베네토 주  << _sbj_ >> 에 있는 휴양도시이다.
윤소종	윤회_(조선)	child	 인물로는  << _sbj_ >> ,  << _obj_ >> , 윤자운 등이 있다.
타주라	지부티	country	타주라 주는  << _obj_ >>  중북부에 위치한 주로 주도는  << _sbj_ >> 이며 면적은 7,100㎢, 인구는 96,830명, 인구 밀도는 14명/㎢이다.
행복의_노란_손수건	야마다_요지	director	 또한 나중에 피트 헤밀의 이야기를 바탕으로 1977년  << _obj_ >> 가 《 << _sbj_ >> 》 이라는 영화를 만들었다.
메멘토_(2000년_영화)	크리스토퍼_놀런	director	《 << _sbj_ >> 》,  << _obj_ >>  감독의 영화, 2000년 작.
아사브	에리트레아	country	홍해 남부 주 또는 데부바위케이바리 주는  << _obj_ >>  동남부와 홍해 연안에 위치한 주로, 주도는  << _sbj_ >> 이며 면적은 27,600km², 인구는 203,618명이다.
마쭈_열도	중화민국	country	금마장은 중국 근해에 위치해 있지만  << _obj_ >> 의 영토인 두 섬 진먼 현와  << _sbj_ >> 의 첫 글자를 따서 이름을 지은 영화제로, 장제스의 국민정부 치하 중화민국의 반공의지가 스며있다.
드네프르_강	러시아	country	스몰렌스크는  << _obj_ >> 의 도시로,  << _sbj_ >> 에 면해 있다.
FIFA_클럽_월드컵_2009	포항_스틸러스	team	그는 UEFA 유로 2008에서 스위스와 체코의 개막전 경기, 그리스와 러시아의 조별 예선 경기, 크로아티아와 터키의 8강전 경기, 독일과 스페인의 결승전 경기의 주심을 맡았으며,  << _sbj_ >> 에서  << _obj_ >> 와 에스투디안테스 라 플라타의 준결승전 경기의 주심을 맡았다.
청춘의_덫_(1999년_드라마)	유호정	starring	송화 역으로 나온  << _obj_ >> 은 <송화>의 전작인 만남  캐스팅 물망에 올랐는데 당시 SBS  << _sbj_ >>  출연 도중 유산의 아픔을 겪었던 유호정은 이런 이유로 만남  출연 제의를 고민하자 이 드라마의 제작진은 유호정의 남편인 이재룡에게 유호정 출연을 설득해 달라고 했지만 본인이 끝내 거절해 버리는 바람에 제작진은 이재룡한테 남자 주인공 역을 제안했으며 결국 이재룡은 출연을 선택했다.
쁘라쭈압키리칸_주	타이	country	후아힌은  << _obj_ >>  서부  << _sbj_ >> 에서 가장 큰 도시로 후아힌 군의 행정 중심지이다.
카림_벤제마	올랭피크_리옹	team	2009년 7월 7일  << _sbj_ >> 를 레알 마드리드 CF에 판  << _obj_ >> 이 그를 2,400만 유로의 가격에 사들였다.
권중현	권태환	child	 대한제국 관료 권재형과 아들 권창현은 을사조약의 비난 때문에 각각  << _sbj_ >> ,  << _obj_ >> 으로 개명하였다.
권중현	권태환	successor	 대한제국 관료 권재형과 아들 권창현은 을사조약의 비난 때문에 각각  << _sbj_ >> ,  << _obj_ >> 으로 개명하였다.
후한_장제	후한_화제	successor	 그러나 그의 넷째 동생이자  << _sbj_ >> 의 서자인  << _obj_ >> 가 황위를 계승하였다.
케나_(도시)	이집트	country	케나 주는  << _obj_ >>  중남부 나일 강에 있는 주로, 주도는  << _sbj_ >> 이다.
메르사마트루	이집트	country	마트루 주는  << _obj_ >>  북서부에서 리비아와 국경을 접하는 주로, 주도는  << _sbj_ >> 이다.
분신사바	최정윤	starring	서은주 역의  << _obj_ >> 은 99년 KBS 1TV 사람의 집 이후 7년 만에 일일극 출연을 했는데, 사실 이 작품 이후 2004년 KBS 1TV 금쪽같은 내새끼의 송지혜 역으로 낙점됐지만 영화  << _sbj_ >>  촬영 스케줄과 겹쳐 고사한 바 있었다.
파이윰	이집트	country	파이윰 주는  << _obj_ >>  나일강 서쪽에 있는 주로, 주도는  << _sbj_ >> 이다.
다케시타_노보루	일본	country	 또 오자와 이치로 등과 함께 1990년대의  << _obj_ >>  정계를 대표하는 정치가의 한 사람이며, 자민당내  << _sbj_ >> 파를 이끌었다.
이오지마에서_온_편지	니노미야_카즈나리	starring	또한  << _obj_ >> 가 영화 《 << _sbj_ >> 》에 출연했을 때, 베를린 국제 영화제에서는 참석을 하였지만, 미국 아카데미상 시상식에서는 참석 사퇴를 신청하였다.
핀란드_만	에스토니아	country	 서남쪽은 발트 해 남쪽은  << _sbj_ >> 을 통해  << _obj_ >> 와 가깝다.
겐조_천황	닌켄_천황	successor	권 제15 - 세이네이 천황,  << _sbj_ >> ,  << _obj_ >> 
옥이_이모	성준기	director	도둑의 딸은 SBS에서 2000년 5월 29일부터 2000년 9월 26일까지 방영되었던 드라마인데 은실이 이후 이어진 월화드라마의 슬럼프를 만회하기 위해 이 작품의 담당 PD  << _obj_ >> 씨를 연출자, 성준기 PD와 함께  << _sbj_ >> 란 드라마에서 호흡을 맞춘 김운경 작가를 집필자로 내세웠다.
남자_만들기	오현경_(1970년)	starring	이와 함께, 1995년 10월 7일 방영분에서 특정 레스토랑의 간판을 노출해 해당업소에 광고효과를 줬다는 이유로 방송위원회로부터 경고 조치를 받았고 비정상적인 내용 전개로 비난을 샀으며 박부희 역으로 나온  << _obj_ >> 을 KBS 2TV 수목 미니시리즈  << _sbj_ >> 와 겹치기 출연시켜 또다시 비판을 받았다.
오남매	이덕화	starring	최영혜 역의 이상아가 출연한 드라마 중의 하나인 SBS  << _sbj_ >> 의 담당 PD 곽영범씨는 자사 드라마 이웃집 여자의 연출자로 낙점되었으나 똑같은 사건에 연루된  << _obj_ >> 를 캐스팅했다는 사실이 알려지자 <그래도 사랑해>의 담당 PD 허웅씨로 연출자를 교체했다.
엄마의_깃발	김세윤	starring	한편, 오연수가 <만강> 후반부 당시에 이 작품과 겹치기 출연한 SBS  << _sbj_ >>  담당 PD 성준기씨는 <만강>에서 이만강 역으로 나온 임호 의 고등학교 선배인데 엄마의 깃발 출연진에 속했던  << _obj_ >>  조민기는 <만강> 담당 연출자 김재순 (연출자 PD의 고등학교 후배인 김국진이 주인공으로 나온 MBC 드라마 반달곰 내 사랑 출연진이었다.
세네갈_강	모리타니	country	  << _sbj_ >>  유역의 세네갈 북쪽과  << _obj_ >> , 말리, 기니에 주로 거주하고 있다.
요르요스_1세	콘스탄티노스_1세	child	 1913년 스파르타의 공작이 되고, 그해 그의 할아버지  << _sbj_ >> 가 암살되고 아버지  << _obj_ >> 가 즉위하자 그는 황태자가 되었다.
요르요스_1세	콘스탄티노스_1세	successor	 1913년 스파르타의 공작이 되고, 그해 그의 할아버지  << _sbj_ >> 가 암살되고 아버지  << _obj_ >> 가 즉위하자 그는 황태자가 되었다.
내_사랑_내_곁에_(영화)	박진표	director	《 << _sbj_ >> 》는  << _obj_ >>  감독, 하지원, 김명민 주연의 영화이다.
메르신_주	터키	country	메르신은  << _obj_ >>   << _sbj_ >> 의 주도다.
베르셰바	이스라엘	country	네게브의 벤-구리온 대학교 는 1969년에 세워졌으며,  << _obj_ >> ,  << _sbj_ >> 에 있다.
실리아나_주	튀니지	country	마크타르는  << _obj_ >> 의  << _sbj_ >> 에 있는 도시이다.
더_퀴즈_쇼	사쿠라이_쇼	starring	2009년 5월 27일 발매한 이 싱글은, 〈明日の記憶〉은 아라시의 멤버  << _obj_ >>  주연의 드라마 《 << _sbj_ >> 》의 엔딩곡으로 사용되었으며, 〈〉는 일본 화장품 KOSE 에스프리크 화장품 라인의 TV-CM 곡으로 사용되었다.
똥파리_(영화)	양익준	starring	《 << _sbj_ >> 》의  << _obj_ >>  감독, 배우 김꽃비
똥파리_(영화)	양익준	director	《 << _sbj_ >> 》의  << _obj_ >>  감독, 배우 김꽃비
올드_미스_다이어리	예지원	starring	《귀여워》, 《 << _sbj_ >> 》의 배우  << _obj_ >>
페드로_라스쿠라인	빅토리아노_우에르타	successor	마데로는 같은 날 대통령직을 사임하고  << _sbj_ >> 이 아주 짧게 대통령직을 수행하고  << _obj_ >> 가 새 대통령이 되었으나 2월 22일 결국 우에르타 정부의 명령으로 자신의 경호원에게 부통령 호세 마리아 피노 레즈와 함께 형장의 이슬로 사라졌다.
명간군	조선민주주의인민공화국	country	룡반역은  << _obj_ >>  함경북도  << _sbj_ >>  룡반로동자구에 위치한 평라선의 철도역이다.
둔황_시	중화인민공화국	country	둔황공항은  << _obj_ >>  간쑤 성  << _sbj_ >> 에 있는 공항이다.
프랭크_시나트라	낸시_시나트라	child	 윌리엄스는  << _sbj_ >> 와  << _obj_ >> 의 곡 〈Somethin' Stupid〉를 니콜 키드먼과 듀엣으로 불렀고, 이것이 영국에서 그의 5번째 1위 싱글곡이 되었다.
조용한_가족	김지운_(영화_감독)	director	 1998년에는 문소리와 함께 단편 영화 《사랑의 힘》에 출연했고, 같은 해  << _obj_ >>  감독의 코미디, 범죄 영화 《 << _sbj_ >> 》에서 영민 역으로 출연했다.
이와세_히토키	주니치_드래건스	team	 2006년 10월 1일 현대 유니콘스전에서 47세이브를 기록, 일본 프로 야구 센트럴 리그 한신 타이거스 소속 후지카와 규지와  << _obj_ >>  소속  << _sbj_ >> 가 공동으로 가지고 있던 아시아 통산 최다 세이브 기록인 46세이브를 경신하였다.
다카하시_고레키요	사이토_마코토	successor	 1936년 2월 26일 육군 하급 장교 22명이 제1사단 휘하 3개 연대와 근위보병연대의 무장 병사들 1,400명을 이끌고 도쿄에서 반란을 일으켜  << _obj_ >>  내대신,  << _sbj_ >>  대장대신, 와타나베 조타로 교육총감을 살해하는 2·26 사건이 일어났다.
박천군	조선민주주의인민공화국	country	청천강역은  << _obj_ >>  평안북도  << _sbj_ >> 에 위치한 평의선의 철도역이다.
애슐리_콜	첼시_FC	team	 전 소속팀  << _obj_ >>  시절에는 같은 포지션의  << _sbj_ >> 에게 밀려 주로 후보 선수로 뛰었지만 맨체스터 시티 FC로 팀을 옮기고 나서는 주전 자리를 확보하였다.
프린세스_다이어리_2	앤_해서웨이	starring	 2004년 단편 영화 "Why Germany?"에 출연하였으며, 8월에 개봉한 《 << _sbj_ >> 》에서는  << _obj_ >> 의 상대 역인 니콜라스 역으로 출연하였다.
행운을_돌려줘	린제이_로한	starring	 또한 로맨틱 코미디인 영화  << _sbj_ >> 에서  << _obj_ >> 이 연기한 애쉴리 올브라이트의 상대 역인 제이크 하딘을 연기하였다.
김동찬	경남_FC	team	 그리고 MVP는 포항 스틸러스의 최효진 이, 득점상은 앞서 얘기했듯이 3골을 넣은  << _obj_ >> 의  << _sbj_ >> 이 받았다.
이스보셋	다윗	successor	압살롬의 난은 연합 이스라엘 왕국  << _obj_ >>  시기 다윗의 아들 압살롬이 일으킨 반란으로 다윗과  << _sbj_ >>  분열 시기 이후 최초로 이스라엘 민족들이 자기끼리 싸운 대전이었다.
사랑할때까지	반효정	starring	여주인공 송미연 역의 유하영은 <욕망>이 마지막 연속극 출연작이었는데 이 작품을 조기종영시키게 한 KBS 1TV  << _sbj_ >> 의 작가 이금림씨는 유하영의 드라마 데뷔작이었던 KBS 1TV 당신이 그리워질 때의 집필자였으며 사랑할때까지의 출연진이었던  << _obj_ >>  김영애  등은 당신이 그리워질 때에서 유하영과 호흡을 맞춘 바 있었다.
2009_FA_커뮤니티_실드	맨체스터_유나이티드_FC	team	2009년 8월 9일, 안첼로티는  << _obj_ >> 와의  << _sbj_ >>  경기에서 2-2로 비긴 후 승부차기로 이겨 첼시 감독으로서 첫 우승을 차지했다.
프랑수아_뒤발리에	장클로드_뒤발리에	child	  << _sbj_ >> 와  << _obj_ >> 가 정권을 잡은 시기였던 1964년 5월 25일부터 1986년 2월 25일까지는 검정색과 빨간색 두 가지 색의 세로 줄무늬 바탕에 국장이 그려진 국기를 사용하였다.
프랑수아_뒤발리에	장클로드_뒤발리에	child	 테레사 수녀는 정치에 상당히 무지하였기 때문에 아이티의 독재자인  << _sbj_ >> 와 그의 아들인  << _obj_ >> 와 함께 사진을 찍기도 하여, 물의를 빚기도 했다.
프랑수아_뒤발리에	장클로드_뒤발리에	successor	  << _sbj_ >> 와  << _obj_ >> 가 정권을 잡은 시기였던 1964년 5월 25일부터 1986년 2월 25일까지는 검정색과 빨간색 두 가지 색의 세로 줄무늬 바탕에 국장이 그려진 국기를 사용하였다.
프랑수아_뒤발리에	장클로드_뒤발리에	successor	 테레사 수녀는 정치에 상당히 무지하였기 때문에 아이티의 독재자인  << _sbj_ >> 와 그의 아들인  << _obj_ >> 와 함께 사진을 찍기도 하여, 물의를 빚기도 했다.
에두아르도_두알데	네스토르_키르치네르	successor	정의당은 2003년 대선을 앞두고 카를로스 메넴,  << _sbj_ >> 의 지원을 받은  << _obj_ >> , 아돌포 로드리게스 사아가 이끄는 세 정파로 갈라졌다.
서독_대_오스트리아_(1982년_FIFA_월드컵)	오스트리아_축구_국가대표팀	team	 1차 조별리그 첫경기에서 알제리 축구 국가대표팀에 1-2로 패하는 수모를 당한 뒤,  << _obj_ >> 와의 최종전에서  << _sbj_ >> 를 거둔 후 2차 조별리그에 진출하였다.
태양의_제국	크리스찬_베일	starring	 스티븐 스필버그의 1987년 영화 《 << _sbj_ >> 》에서 주인공 제이미역을 맡은  << _obj_ >> 이 극중 불러 널리 알려지게 된 곡이다.
대런_벤트	선덜랜드_AFC	team	가장 빠른 골 : 36초-  << _obj_ >> 의  << _sbj_ >>  
아널드_슈워제네거	오스트리아	country	그의 딸 마리아 슈라이버는  << _obj_ >>  출신의 영화 배우로 현재 캘리포니아 주인  << _sbj_ >> 의 부인이다.
칼_야스트렘스키	보스턴_레드삭스	team	 당시 유일했던 1안타는  << _obj_ >> 의 간판타자  << _sbj_ >> 가 뽑아낸 2루타였고, 페이지는 모든 이들을 놀라게 하며 메이저 리그 최고령 선수로 역사의 한 페이지를 장식하면서 은퇴를 하게 되었다.
우리카드	우리은행	successor	 지원하는 은행은 신한은행,  << _obj_ >> , 한국씨티은행이며, 그 중 우리은행은  << _sbj_ >> 의 체크카드인 "우리BC ONE 체크카드 국제ATM" 상품을 통해서만 발급받을 수 있다.
마티아스	페르디난트_2세	successor	예세니우스는 30년 전쟁의 발단이 된 “귀족들의 반란”을 주도했다가 체포되었으며, 이후 1619년에  << _sbj_ >>  황제가 사망하고 가톨릭 교도인  << _obj_ >> 가 황제로 즉위하고 26명의 다른 보헤미아인 대표들과 함께 올드 타운 광장에서 처형당했다.
송정현	대구_FC	team	 결국 2006년  << _obj_ >> 로 이적하였고, 이후 타 팀으로 이적한  << _sbj_ >> 과 홍순학의 공백을 메우며 이름을 알렸다.
조원희	경남_FC	team	 시즌 종료 후 강원과의 재계약에 실패하며 반년 가까이 무적신분으로 지냈고, 2014년 7월  << _obj_ >> 로 이적해  << _sbj_ >> 의 공백을 메웠지만, 팀의 강등을 막지는 못하였다.
디스_이즈_디_엔드	세스_로건	starring	 왓슨은 아포칼립틱 코미디 영화 《 << _sbj_ >> 》에 출연해, 그녀는 “자신들의 과장 된 버전”이라고 설명하며  << _obj_ >> , 제임스 프랭코와 그외 많은 공연자들과 연기했고, 왓슨은 잊지 못할 Fuck을 날렸다.
디스_이즈_디_엔드	세스_로건	starring	 죽마고우인  << _obj_ >> 과의 협작 영화들로 잘 알려져 있으며, 대표작으로 《슈퍼배드 》, 《파인애플 익스프레스》, 《 << _sbj_ >> 》, 《디 인터뷰》가 있다.
디스_이즈_디_엔드	세스_로건	director	 왓슨은 아포칼립틱 코미디 영화 《 << _sbj_ >> 》에 출연해, 그녀는 “자신들의 과장 된 버전”이라고 설명하며  << _obj_ >> , 제임스 프랭코와 그외 많은 공연자들과 연기했고, 왓슨은 잊지 못할 Fuck을 날렸다.
디스_이즈_디_엔드	세스_로건	director	 죽마고우인  << _obj_ >> 과의 협작 영화들로 잘 알려져 있으며, 대표작으로 《슈퍼배드 》, 《파인애플 익스프레스》, 《 << _sbj_ >> 》, 《디 인터뷰》가 있다.
상명대학교	대한민국	country	최근 중국의 젓가락형제의 작은사과를 리메이크하여 한중프로젝트로 "Little Apple with 젓가락형제" 컴백하여 활동하였고, 12월 14일  << _sbj_ >>  상명아트센터 계당홀에서 공식 2기 팬미팅을 하였으며, 12월 25일에는 코엑스 오디토리움에서 "Dear My Family"라는 이름의  << _obj_ >>  첫 단독 콘서트를 열었다.
로베르토_로하스_스캔들	칠레_축구_국가대표팀	team	  << _obj_ >> 는 브라질과의 원정 경기 도중에  << _sbj_ >> 이 발생하는 바람에 그대로 실격 처리되었으며, 이 여파로 칠레는 다음 대회인 1994년 FIFA 월드컵 출전 자격을 박탈당했다.
태희혜교지현이	정선경	starring	MBC 《 << _sbj_ >> 》에서 박미선,  << _obj_ >> , 홍지민, 최은경 , 김희정 이 패러디했다.
카를로스_2세_(스페인)	펠리페_5세	successor	 스페인의 왕  << _sbj_ >> 가 1700년 사망하자 스페인의 합스부르크 왕가의 혈통은 끊어지고 말았고, 이에 따라 합스부르크 왕가에서는 루이 14세의 손자이자 카를로스 2세에 의해서 후계자로 지목된  << _obj_ >> 에 대항하여 카를이 적법한 계승자라고 주장하였다.
내_남자의_여자	대한민국	country	송재호는  << _obj_ >> 의 배우이며, 출연작으로는 《부모님 전상서》, 《 << _sbj_ >> 》 등이 있다.
료마전	오오모리_나오	starring	《 << _sbj_ >> 》 ...  << _obj_ >>
오주원	넥센_히어로즈	team	 결국  << _sbj_ >> 은 이듬해 시즌을 끝으로 상무에 입대했고,  << _obj_ >> 로 인계된 이후 복귀하였다.
잠파올로_파치니	UC_삼프도리아	team	 그는 이후,  << _obj_ >> 와의 경기에서 밀란의 선제골을 넣었지만, 60분에  << _sbj_ >> 에게 동점골을 얻어맞아 무승부로 경기가 끝났다.
루이스_펠리피_스콜라리	광저우_헝다_타오바오	team	2015년 7월 16일, 호비뉴는 같은 국적  << _sbj_ >> 가 이끄는 중국 슈퍼리그의  << _obj_ >> 와 6개월 계약을 맺었고, 전 국가대표팀 동료 파울리뉴와 동행하게 되었다.
호나우지뉴	FC_바르셀로나	team	 그 때 그는 라파엘 마르케스,  << _sbj_ >>  등을 영입해  << _obj_ >>  선수진을 보강했다.
유상철	요코하마_F._마리노스	team	 2003 시즌이 중반엔 에이스였던  << _sbj_ >> , 이천수가 각각  << _obj_ >> 와 레알 소시에다드로 떠났고, 시즌이 끝난 후에는 팀의 전설이라 불릴만한 김현석이 은퇴하였다.
안드레_루이스_타바레스	포항_스틸러스	team	 그러나 그 해 득점왕을 기록한  << _sbj_ >> 의  << _obj_ >> 에게 패배하고 말았다.
김두현_(축구_선수)	성남_FC	team	 구단은 2014 시즌을 끝으로 K리그 자유계약선수제도 신분이 된 염기훈과  << _sbj_ >> 과 반드시 계약을 성사해야 팀의 입장에서도 더 높은 성적을 내다볼 수 있었지만 구단의 재정 악화로 몸값이 높은 두 선수를 잡기가 쉽지 않았고 긴 협상 끝에 염기훈은 자신의 연봉을 삭감하며 1년 재계약으로 팀에 합류하였으며, 김두현은  << _obj_ >> 로 이적하였다.
조원희	서울_이랜드_FC	team	 카이우 펠리피 곤사우베스의 대체 외국인 선수로, 브라질 출신 이고르 클레베르 가르시아 시우바를 영입하였고, 이후  << _obj_ >> 에서 뛰던  << _sbj_ >> 가 6년 만에 복귀하였다.
난창_시	중화인민공화국	country	둥후 구는  << _obj_ >>  장시 성  << _sbj_ >> 의 현급 행정구역이다.
코스타스_카라만리스	요르요스_파판드레우_(1952년)	successor	 두 번에 걸쳐 집권한  << _sbj_ >> 의 신민주주의당이 1위로 41.83%를 얻었으며,  << _obj_ >> 와 범그리스 사회주의 운동이 38.10%를 얻었다.
다나카_가쿠에이	미키_다케오	successor	 하지만, 다나카 내각은 경제 정책의 실패와 금맥 문제의 책임을 지고 1974년 사퇴를 표명하였으며,  << _sbj_ >> 의 후계를 둘러싸고 시나는 대파벌의 우두머리인 오히라 마사요시와 후쿠다 다케오를 배제하고,  << _obj_ >> 를 신총재로 선출하였는데, 이를 시나 재정  이라고 한다.
안도니_수비사레타	FC_바르셀로나	team	1987-88 시즌 프리메라리가와 코파 델 레이에서  << _obj_ >> 에 밀려 준우승을 차지한 뒤 1988년 FC 바르셀로나로 팀을 옮겼고, 주전으로 뛰면서  << _sbj_ >> , 훌리오 살리나스, 욘 안도니 고이코에체아 등의 다른 바스크 출신 선수들과 함께 뛰면서 4번의 리그 우승 등을 경험하며 팀의 전성기와 함께하였다.
아하이아_현	그리스	country	파트라 또는 파트라이는  << _obj_ >> 에서 세 번째로 큰 도시로, 펠로폰니소스 반도 북부에 있는  << _sbj_ >> 의 현 소재지이며, 아테네와는 서쪽으로 215km 떨어져 있다.
대한민국_제18대_국회의원_선거	대한민국	country	박영선은  << _obj_ >> 의 언론인 출신 정치인으로 대한민국 제17대 국회의원 선거· << _sbj_ >> ·대한민국 제19대 국회의원 선거·대한민국 제20대 국회의원 선거 국회의원이다.
뜨거운_형제들	이기광	starring	 'Take You Down'은 1년 후인 2010년,  << _obj_ >> 이  << _sbj_ >> 에서 미국춤을 춰 화제가 되었으며 대한민국에서는 미국춤 배경음악으로 잘 알려져 있다.
클라렌서_세이도르프	FC_인테르나치오날레_밀라노	team	베르흐캄프가 1993년에  << _obj_ >> 로 이적하자, 판 할은 프랑크 더 부르와 로날트 더 부르, 에드빈 판 데르 사르,  << _sbj_ >> , 엣하르 다비츠, 마이컬 레이저허르, 그리고 빈스톤 보하르더 등의 아카데미 졸업생들과 피니디 조지, 은완코 카누, 그리고 야리 리트마넨등의 민첩한 외국 용병, 그리고 베테랑 주장 다니 블린트로 구성된 젊은 아약스의 약점을 보완하기 위해 프랑크 레이카르트를 재영입하였다.
이여상	롯데_자이언츠	team	그러나 그 해 11월 22일에 열린 2차 드래프트에서  << _sbj_ >> 만  << _obj_ >> 의 지명을 받았고, 정근우의 FA 보상선수를 지명하려던 SK 와이번스에서는 “데려갈 만한 선수가 없다”라는 입장을 밝혀 여전히 한화 이글스에서는 얇은 선수층의 한계를 드러내고 있다.
아벨상	노르웨이	country	 노벨상과 어느 정도 연관이 있는 상으로는 2003년부터  << _obj_ >> 가 수여하는  << _sbj_ >> 이 있다.
심수창	한화_이글스	team	) 한편, FA를 통해  << _sbj_ >> 을  << _obj_ >> 에 내주면서 박한길을 보상선수로 영입하였다.
마파도	추창민	director	《사랑을 놓치다》는 영화 《 << _sbj_ >> 》를 통해 흥행감독으로 떠오른  << _obj_ >>  감독의 첫 멜로물로, 대학시절부터 이어진 10년이라는 시간동안 만남과 헤어짐을 반복해 온 두 남녀의 '인연'에 관한 이야기이다.
페르난도_무슬레라	SS_라치오	team	그리고 또 다시 1년 만에  << _sbj_ >> 와 교환되어  << _obj_ >> 로 왔다.
사이릭스	내셔널_세미컨덕터	successor	이 시리즈는 원래  << _obj_ >> 에서 1999년 발표한 것으로 오리지널 지오드 코어는  << _sbj_ >> 의 미디어GX를 기반으로 하고 있다.
최운해	최윤복	child	 증조는 여말선초의 명장이자 참판승추부사를 지낸 양장공  << _sbj_ >> 이고, 조부는 운해의 차자로 풍저창부사, 사헌부감찰, 의주판관을 지낸  << _obj_ >> 이다.
파블로_비야	코르도바_CF	team	 3년 후, 페레는  << _sbj_ >>  감독의 후임으로 세군다 디비시온의  << _obj_ >> 의 지휘봉을 잡았다.
송준길	인현왕후	child	어려서  << _sbj_ >> 의 문하에서 학문을 배우고 1681년에 과거 제도에 장원 급제하여 성균관에 입학하였으며, 1688년  << _obj_ >>  폐출사건 때 파직당했다가 1694년 인현왕후가 복위되면서 금부도사로 채용되었다.
안녕,_프란체스카	노도철	director	이두일은 2005년에 방송된  << _obj_ >> PD의 문화방송 시트콤 《 << _sbj_ >> 》에 출연하여 배우 심혜진과 연기호흡을 맞췄다.
용맹공_장	선량공_필리프	successor	 프랑스 측의 음모로 인해 몽트로에서 도팽 일행에게  << _sbj_ >> 이 암살당하면서 절정에 달했다. 그래서 새로운 부르고뉴 공작  << _obj_ >> 는 헨리 5세의 잉글랜드군과 손을 잡고 6개월의 교섭 끝에 트루아 조약이 체결되었다.
이흥련	경찰_야구단	team	 그 후, 보상선수로  << _obj_ >> 에서 군복무 중인  << _sbj_ >> 을 영입하였다.
훌리오_살리나스	아틀레틱_빌바오	team	 1994년  << _obj_ >> 로 이적해 3시즌 동안 활약하다 일본 J리그의 요코하마 F. 마리노스에 입단하여  << _sbj_ >> 와 다시 한 번 같은 팀에서 활약하게 되었다.
루이_11세	잔_드_프랑스	child	 루이 12세가 14살이 되던 1476년 당시 프랑스의 왕이었던  << _sbj_ >> 는 그의 둘째 딸인  << _obj_ >> 를 루이 12세와 결혼시켰다.
말리크샤_1세	마흐무드_1세_(셀주크_제국)	child	셀주크 제국의  << _obj_ >> : 셀주크 제국의 4번째 술탄.  << _sbj_ >> 의 아들.
말리크샤_1세	마흐무드_1세_(셀주크_제국)	successor	셀주크 제국의  << _obj_ >> : 셀주크 제국의 4번째 술탄.  << _sbj_ >> 의 아들.
가말_압델_나세르	안와르_사다트	successor	1961년  << _sbj_ >> 가 엘 샤페이를 부통령으로 임명했고, 1971년  << _obj_ >> 가 다시 부통령으로 임명했다.
톰_시버	뉴욕_메츠	team	 또한 1971년 아메리칸 리그 챔피언쉽에서부터 가을만 되면 공격력이 폭발했던 잭슨은  << _obj_ >> 와의 월드시리즈에서 상대팀 투수  << _sbj_ >> 를 무너뜨리면서, 월드시리즈에서 1개의 홈런과 6타점으로 월드시리즈 MVP를 거머쥐는 영광을 안게 되었다.
빌리_마틴	뉴욕_양키스	team	 오클랜드 어슬레틱스시절과  << _obj_ >> 시절, 자신과 함께 했던  << _sbj_ >>  감독과도 사이가 좋지 못 하였고, 또한 괴팍하기로 유명했던 양키스 구단주 조지 스타인브레너와는 더더욱 사이가 좋지 못 하였다.
팜파스	브라질	country	 후에 스페인에 점령되었으나,  << _obj_ >>  독립 후 브라질의  << _sbj_ >>  지방의 중심지로 발전하였다.
선덕여왕_(드라마)	고현정	starring	드라마 《 << _sbj_ >> 》 :  << _obj_ >> 과 유이 가 미실 역을 연기했고, 극중에서는 덕만과 대립하여 반란을 일으켰으나 실패하여 자살로 생을 마감했다.
베이컨시	루크_윌슨	starring	 파커는 《우리, 사랑해도 되나요?》에서 함께 주연을 맡았던  << _obj_ >> 과 함께 《 << _sbj_ >> 》에 출연할 예정이었으나 다른 프로젝트로 빠지면서 케이트 베킨세일이 역할을 대신 맡았다.
남에게_주	그리스	country	에르무폴리 또는 에르무폴리스는  << _obj_ >>   << _sbj_ >> 의 한 도시이다.
이타쿠라_정	일본	country	도요 대학은  << _obj_ >>  도쿄 도 분쿄 구, 사이타마 현 아사카 시, 사이타마 현 가와고에 시, 군마 현  << _sbj_ >> 에 있는 사립 대학이다.
나플리오	그리스	country	아르고스는  << _obj_ >>  펠로폰네소스 반도에 있는 도시로, 신화상의 영웅 나우플리오스에서 따온 유서깊은 항구 도시  << _sbj_ >> 가 있다.
공부의_신	김수로_(배우)	starring	 한편  << _sbj_ >> 은 2010년 초 KBS 2TV로 방송사가 변경되었으며 오지호 자리에는  << _obj_ >> 가 대타로 들어갔다.
윤재국	한화_이글스	team	 서승화와의 사건으로 부상을 당했던  << _sbj_ >> 은 설상가상으로 비리까지 얽히면서 2004년을 완전히 접고 복귀 후  << _obj_ >> 에 트레이드되었다.
포토시_주	볼리비아	country	포토시는  << _obj_ >> 의  << _sbj_ >> 의 주도이다.
조제_소크라트스	페드루_파수스_코엘류	successor	 이에 따라 사회당의  << _sbj_ >>  前 총리와 함께 포르투갈에는 좌우 동거 정부가 들어섰으나, 총리는 같은 당인  << _obj_ >> 였고, 포르투갈 헌법에 의거하여 2016년 3월 9일에 대통령 자리에 퇴임하였다.
V-리그_(대한민국)	안산_OK저축은행_러시앤캐시	team	김세진은 대한민국의 배구 선수, 지도자로,  << _sbj_ >> 의 팀인  << _obj_ >> 의 초대 감독이다.
용문사_(양평군)	대한민국	country	 군내에는 기암 괴석과 울창한 수림을 이룬 용문산이 있는데, 이 산에는 신라 선덕여왕 3년 원효대사의 개기에 의한 대찰  << _sbj_ >> 가 있고 경내에는 수령이 1,000년이 넘는  << _obj_ >>  최고의 은행나무가 있다.
이범준_(야구_선수)	LG_트윈스	team	 2010년 5월 12일 청주야구장에서 열린  << _obj_ >> 와의 경기에서 투수  << _sbj_ >> 을 상대로 프로 첫 만루 홈런을 기록하여 한화의 8-7 승리에 기여했다.
마르코_폴로_(드라마)	베네딕트_웡	starring	《 << _sbj_ >> 》 -  << _obj_ >>
신데렐라_언니	천정명	starring	  << _obj_ >> , 서우, 택연 등과 같이 출연한 《 << _sbj_ >> 》에서 그녀는 기존의 귀여운 이미지를 탈피, 까칠하고 냉소적인 송은조 역으로 연기 변신에 성공, 호평을 받았다.
신데렐라_언니	서우	starring	 천정명,  << _obj_ >> , 택연 등과 같이 출연한 《 << _sbj_ >> 》에서 그녀는 기존의 귀여운 이미지를 탈피, 까칠하고 냉소적인 송은조 역으로 연기 변신에 성공, 호평을 받았다.
페루자	이탈리아	country	1536년 2월 24일  << _obj_ >> 의 파도바에서 태어나  << _sbj_ >> , 볼로냐 등지에서 법학을 공부한 후 박사 학위를 받고 교황 비오 5세 밑에서 일하였고 교황청에서 여러 직책을 맡았다.
교황_빅토르_2세	교황_스테파노_9세	successor	 레오 9세의 뒤를 이어 즉위한  << _sbj_ >> 는 일데브란도를 재차 교황 특사로 임명했으며, 빅토르 2세의 뒤를 이어 즉위한  << _obj_ >> 는 그를 루카의 안셀모와 함께 독일로 보내서 당시 제국의 섭정이었던 푸아투의 아그네스 태후로부터 자신의 교황 선출에 대한 승인을 받아오라고 지시하였다.
교황_마리노_1세	교황_하드리아노_3세	successor	 요한 8세 이후  << _sbj_ >> ,  << _obj_ >> , 교황 스테파노 5세, 교황 포르모소가 재임한 시절에도 그의 성직은 그대로 유지되었다.
교황_실베리오	교황_비질리오	successor	 그사이 아가피토 1세의 뒤를 이은  << _sbj_ >> 가 물러나고 부제였던  << _obj_ >> 가 교황이 되었다.
폰차	이탈리아	country	교황 실베리오는 대중의 지지를 받아 훗날 성인 으로 시성 되었으며,  << _obj_ >>   << _sbj_ >> 의 수호성인으로 지정되었다.
스토리_오브_와인	노민우_(1986년)	starring	 서현진은 SM 소속되어 있을 때 작품 OST와 SM TOWN의 편집 음반 등에서 솔로 아티스트로 활동했으며, 같은 소속사였던 동방신기,  << _obj_ >> 와 함께 《사랑따윈 필요없어》, 《베케이션》, 《지구에서 연애 중》, 《유쾌한 도우미》, 《 << _sbj_ >> 》 등의 영화에 출연하며, 간간히 《황진이 》 등과 같은 텔레비전 드라마에도 단역으로 얼굴을 보였다.
비치_(영화)	대니_보일	director	2000년 알렉스 가랜드의 동명 소설을 영화화한  << _obj_ >> 의 《 << _sbj_ >> 》에서는 틸다 스윈턴, 비르지니 르두아앵, 기욤 카네와 공연하였고, 미국에서 배낭 하나만 매고 태국의 비밀의 섬에 모험을 찾는 청년 리처드를 연기했다.
사마라_(이라크)	이라크	country	 847년 재위해 861년까지  << _obj_ >> 의  << _sbj_ >>  일대를 다스렸으며 그는 그의 형이던 알와티크를 계승했다.
캐치_미_이프_유_캔	마틴_신	starring	 그 해 개봉한 스티븐 스필버그 감독의 영화 《 << _sbj_ >> 》에서는 1960년대 실제로 일어 난 희대의 사기극을 경쾌하게 그린 작품으로 톰 행크스,  << _obj_ >> , 크리스토퍼 워컨 등과 공연하였다.
아비아_주	나이지리아	country	아바는  << _obj_ >> 의  << _sbj_ >> 에 위치한 도시이며, 인구수는 2006년을 기준으로 931,872명의 주민이 거주하고 있다.
이미영_(배우)	보람	child	탤런트  << _sbj_ >> 은 막내 여동생이며, 티아라 의 前 멤버  << _obj_ >> , 디유닛의 R.A.M은 그의 조카딸 들이다.
길소뜸	임권택	director	 10년 정도 수업을 쌓아 85년  << _obj_ >>  감독의 ' << _sbj_ >> '으로 데뷔하였다.
뉴머신_우뢰매_5	김청기	director	  << _obj_ >>  감독의 문하생으로 《 << _sbj_ >> 》, 《색녀도》, 《자유여자》, 《슈퍼 홍길동》등의 조감독으로 시작하였다.
꿈의_크레용_왕국	사토_준이치	director	이 작품의 친 부모는 전작  << _sbj_ >> 의 프로듀서였던 세키 히로미, 극작가 야마다 타카시, 시리즈 디렉터였던  << _obj_ >> 의 세 명이다.
기아_스펙트라	기아_쎄라토	successor	 미국 시장에 진출한 것도 이 때부터로, 기아 프라이드 후속 차종인 기아 리오,  << _sbj_ >> , 기아 옵티마, 기아 쏘렌토,  << _obj_ >>  등 꾸준히 새로운 차종을 수출하면서 2003년에는 미국 수출 연간 20만대를 돌파하였다.
박충훈	전두환	successor	 서울 장충체육관에서 통일주체국민회의 의장 권한 대행  << _sbj_ >> 에 의해  << _obj_ >> 이 당선되었으며 최규하는 대통령에 오른 뒤 8개월 21일 만에 물러났다.
베저_강	독일	country	브레머하펜은  << _obj_ >>  브레멘 주의 도시로  << _sbj_ >>  어귀에 있는 도시이다.
이나게_구	일본	country	지바 대학은  << _obj_ >>  지바 현 지바 시  << _sbj_ >>  야요이 정 1-33에 본부를 두고 있는 국립대학이다.
바버라_부시	조지_W._부시	child	 전선에서 돌아온 후 22세에  << _sbj_ >> 와 결혼했고 이듬해 장남  << _obj_ >> 가 태어났다.
도쿠가와_요시무네	도쿠가와_이에시게	child	이러한 재정난 속에서 기이노쿠니 기이 도쿠가와 씨 출신으로 제8대 쇼군이 된  << _sbj_ >> 는 이에야스 시대의 정치 제도를 바탕으로 교호 개혁을 단행하였고, 제9대 쇼군  << _obj_ >>  대에는 다누마 오키쓰구 등 다누마 씨를 중심으로 하여 재정 회복을 꾀하였지만 결국 당대에 일어난 기근과 같은 자연 재해로 인하여 실패, 결국 실각하게 되었다.
도쿠가와_요시무네	도쿠가와_이에시게	child	  << _sbj_ >> ,  << _obj_ >> , 도쿠가와 이에하루 3대를 모셔서 이에하루로부터 '니시노마루 할아버지'라 불리며 신뢰를 받았다.
도쿠가와_요시무네	도쿠가와_이에시게	child	쇼군 : 에도 막부의  << _sbj_ >> ,  << _obj_ >>
도쿠가와_요시무네	도쿠가와_이에시게	child	1735년부터 1747년까지 재위하는 동안 1735년부터 1745년까지  << _sbj_ >> 가 섭정하였고 1745년부터 1747년까지  << _obj_ >> 가 섭정하였다.
도쿠가와_요시무네	도쿠가와_이에시게	successor	이러한 재정난 속에서 기이노쿠니 기이 도쿠가와 씨 출신으로 제8대 쇼군이 된  << _sbj_ >> 는 이에야스 시대의 정치 제도를 바탕으로 교호 개혁을 단행하였고, 제9대 쇼군  << _obj_ >>  대에는 다누마 오키쓰구 등 다누마 씨를 중심으로 하여 재정 회복을 꾀하였지만 결국 당대에 일어난 기근과 같은 자연 재해로 인하여 실패, 결국 실각하게 되었다.
도쿠가와_요시무네	도쿠가와_이에시게	successor	  << _sbj_ >> ,  << _obj_ >> , 도쿠가와 이에하루 3대를 모셔서 이에하루로부터 '니시노마루 할아버지'라 불리며 신뢰를 받았다.
도쿠가와_요시무네	도쿠가와_이에시게	successor	쇼군 : 에도 막부의  << _sbj_ >> ,  << _obj_ >>
도쿠가와_요시무네	도쿠가와_이에시게	successor	1735년부터 1747년까지 재위하는 동안 1735년부터 1745년까지  << _sbj_ >> 가 섭정하였고 1745년부터 1747년까지  << _obj_ >> 가 섭정하였다.
박진만	SK_와이번스	team	 2010 시즌 후 기회를 잃은  << _sbj_ >> 이 삼성 라이온즈에 방출을 요청하여 연고 팀  << _obj_ >> 로 이적했고, 박진만의 이적으로 유격수 자리에 완전히 안착하여 경북고등학교 시절 그가 달았던 등번호 7번을 되찾았다.
저수지의_개들	쿠엔틴_타란티노	starring	 짐 자머시의 〈천국보다 낯선〉, 올리버 스톤의 〈플래툰〉, 스티븐 소더버그의 〈섹스·거짓말·비디오테이프〉,  << _obj_ >> 의 〈 << _sbj_ >> 〉과 〈펄프 픽션〉 등이 잘 알려져 있다.
저수지의_개들	쿠엔틴_타란티노	starring	 《 << _sbj_ >> 》로  << _obj_ >> 와 같이 데뷔하였고, 이후 타란티노의 영화 《펄프 픽션》 등을 더 찍었다.
저수지의_개들	쿠엔틴_타란티노	director	 짐 자머시의 〈천국보다 낯선〉, 올리버 스톤의 〈플래툰〉, 스티븐 소더버그의 〈섹스·거짓말·비디오테이프〉,  << _obj_ >> 의 〈 << _sbj_ >> 〉과 〈펄프 픽션〉 등이 잘 알려져 있다.
저수지의_개들	쿠엔틴_타란티노	director	 《 << _sbj_ >> 》로  << _obj_ >> 와 같이 데뷔하였고, 이후 타란티노의 영화 《펄프 픽션》 등을 더 찍었다.
플래툰	올리버_스톤	director	 짐 자머시의 〈천국보다 낯선〉,  << _obj_ >> 의 〈 << _sbj_ >> 〉, 스티븐 소더버그의 〈섹스·거짓말·비디오테이프〉, 쿠엔틴 타란티노의 〈저수지의 개들〉과 〈펄프 픽션〉 등이 잘 알려져 있다.
첸탕_강	중국	country	 브라질의 아마존 강과  << _obj_ >> 의  << _sbj_ >>  등에서 일어나는 현상이다.
미야자와_기이치	호소카와_모리히로	successor	 1991년  << _sbj_ >>  내각의 일본 대장성, 1993년 6월 23일에 자민당을 탈당하여 신생당을 결성함과 동시에 당수로 취임했고, 8월 9일에 출범한  << _obj_ >>  내각에서 부총리 겸 일본 외무성을 지냈다.
사이토_마코토	오카다_게이스케	successor	 계속해서  << _sbj_ >>  내각과  << _obj_ >>  내각에서도 대장 대신으로 일했다.
데몰리션_맨	실베스터_스탤론	starring	블록의 최초로 이름을 알린 영화는  << _obj_ >> 과 웨슬리 스나이프스가 스타가 되었던,공상과학 영화, 《 << _sbj_ >> 》에서였다.
장미가_없는_꽃집	카토리_싱고	starring	《 << _sbj_ >> 》: 1월 14일 ~ 3월 24일, 주연:  << _obj_ >> , 다케우치 유코)
노리코의_식탁	소노_시온	director	존경하는 영화 감독은 《 << _sbj_ >> 》에서 함께 일했던  << _obj_ >>  감독.
한국씨티은행	대한민국	country	 한때 미국과 세계 최대의 은행이었으나, 현재는 미국 내에서 자산과 예금 규모로 뱅크 오브 아메리카와 JP모간 체이스 다음이다  << _obj_ >> 에는 퍼스트 내셔널 시티 뱅크 시절인 1967년 서울에 지점을 내어 진출하여 기업금융을 담당하였고, 1980년대 말부터 소매금융도 취급하기 시작하였고, 1990년대에 각지에 지점을 내어 영업망을 확충한 데 이어, 2004년에는 한미은행과 합병하여  << _sbj_ >> 을 설립하여 점포망을 크게 늘렸다.
이대진	KIA_타이거즈	team	개인 통산 100승 달성:  << _obj_ >>   << _sbj_ >>  
알리투스_주	리투아니아	country	알리투스는  << _obj_ >> 에 있는 도시로  << _sbj_ >> 의 주도이다.
다빈치_코드_(영화)	톰_행크스	starring	 2006년에는 소니픽처스가 판권을 구입하여  << _obj_ >> 를 주연으로  << _sbj_ >> 로 개봉하였다.
미녀와_야수_(1991년_영화)	미국	country	린다 울버턴은  << _obj_ >> 의 여성 작가이며, 월트 디즈니 컴패니의 애니메이션 영화 《 << _sbj_ >> 》와 《라이온 킹》의 영화 각본을 쓴 것으로 잘 알려져 있다.
구도_기미야스	후쿠오카_소프트뱅크_호크스	team	고교 졸업 후 에 취직하면서 2000년에는 도시 대항 야구 대회 출전에 기여했고 대회 직후에 2000년 하계 올림픽 야구 일본 국가 대표로 발탁되어 올림픽 본선에 출전했다. 이듬해 2001년 사회인 야구 일본 선수권 대회에서는 팀의 첫 우승을 달성했고 그 해 가을에 있은 프로 야구 드래프트 회의에서 후쿠오카 현에 연고지를 둔  << _obj_ >> 로부터 3순위 지명을 받고 입단해 자신이 동경하고 있던  << _sbj_ >> 와 같은 등번호 47번이 주어졌다.
줄리우_바프티스타	레알_마드리드_CF	team	 잉글랜드에서의 첫 시즌엔 훌륭한 모습을 보였으나 이후 부상, 적응 실패로 큰 활약을 보여주지 못하자 아스널은  << _obj_ >> 의  << _sbj_ >> 와의 맞임대 조건에 합의하여 레예스를 레알 마드리드로 임대보내게 되었다.
멈출_수_없어	김규리_(1979년_6월)	starring	담당 PD 문보현씨가 조연출로 참여한 드라마 중의 하나인 KBS 2TV 월화 미니시리즈 봄날은 간다 는 <집으로 가는 길>이 그랬던 것처럼 중장년층을 거의 대부분의 주요 시청자로 삼았던 탓인지 기대 이하의 성적에 그쳤는데 이 작품에서 오자희 역으로 나온  << _obj_ >> 와 오선영 역의 이보희는 MBC  << _sbj_ >> 에서 호흡을 맞췄다.
왕황후_(당나라)	측천무후	successor	1. 열전 제1 후비 상 - 태목황후・문덕황후 ・서혜비・ << _sbj_ >> ・ << _obj_ >> ・和思趙皇后・폐후 위씨・상관소용・숙명유황후・소성두황후・왕황후 ・정순무황후・원헌양황후・양귀비
한국외환은행	KEB하나은행	successor	 이후 하나금융지주가  << _sbj_ >> 을 인수하고 몇 년 있다가 2015년 9월 1일 통합  << _obj_ >> 이 출범하였는데, 존속 법인을 한국외환은행으로 하게 되어 서울은행 법인 자체는 완전히 소멸하였다.
조너선_파펠본	필라델피아_필리스	team	 여러 투수가 합작한 가장 최근 기록은 2014년 9월 1일  << _obj_ >> 의 콜 해멀스, 제이크 디크먼（）,켄 자일즈（） 및  << _sbj_ >> 이 애틀랜타 브레이브스를 상대로 기록했다.
윤영춘	윤형주	child	 당숙은  << _sbj_ >> 으로 후일 가수가 되는  << _obj_ >> 는 그의 6촌 재종이었다.
킬_빌	쿠엔틴_타란티노	director	 "아시아 액션 영화의 스승"으로 불리기도 하며,  << _obj_ >> 는 《죽음의 다섯손가락》에 대한 오마주로서  << _sbj_ >> 에서 그 영화에 사용된 음악을 삽입하였다.
론_놀	크메르_공화국	country	캄보디아 내전은 크메르 루주 등 베트남의 지원을 받는 공산군과 미국의 지원을 받은  << _sbj_ >> 의  << _obj_ >>  정부군 간의 내전과 더불어 4파 합동 정권이 통일할 때까지, 20세기 후반에 계속된 캄보디아의 내전 상태를 말한다.
메트로폴리스_(영화)	프리츠_랑	director	《 << _sbj_ >> 》은  << _obj_ >> 이 제작한 무성영화이다.
김병지	FC_서울	team	 그러나 2008년  << _obj_ >> 의 주전 골키퍼로 성장하여 칠레 축구 국가대표팀와의 A매치 경기에서 허리 부상을 입어 시즌 초반 아웃된  << _sbj_ >> 의 빈 자리를 채웠고, 그 해 리그에서 24경기를 뛰며 경기 출전횟수를 늘렸으며, 2008년 K리그 준우승에 공헌하였다.
울릉도	대한민국	country	 '울릉'이란 명칭은  << _obj_ >> 의  << _sbj_ >> 에서 차용한 것으로, 이 명칭을 통해 울릉분지의 위치를 쉽게 파악할 수 있다.
무하마드_오마르	탈레반	country	 빈라덴은  << _sbj_ >> 가 이끌었던  << _obj_ >>  치하의 아프가니스탄이야말로 “유일한 이슬람 국가”라고 하였다.
주룽지	중화인민공화국	country	뉴스 프로그램을 진행하면서 빌 클린턴 미국 대통령,  << _sbj_ >>   << _obj_ >>  총리, 대한민국의 노무현 대통령 등 일본을 방문한 외국 국가 원수들과 "일본 국민과의 대화"라는 프로그램을 진행했으며, 2000년 2월 청와대에서 김대중 대통령과의 단독 인터뷰, 2008년 4월에 이명박 대통령의 일본 방문 당시 "이명박 대통령과의 직접 대화"를 진행하기도 했다.
발라타	이탈리아	country	 란디니의 작품으로 알려져 있는 곡은 마드리갈 11곡, 캇차 2곡,  << _sbj_ >>  114곡으로 모두 세속적인 2-3성의 성악곡인데, 그것은 아르스 노바의 이탈리아 음악의 약 4분의 1에 해당하며, 그는 진정 14세기  << _obj_ >> 를 대표하는 음악가로 되어 있다.
안달루시아의_개	루이스_부뉴엘	starring	 그 중에도  << _obj_ >> 의 《 << _sbj_ >> 》, 《황금시대》, 제르메느 뒬라크의 《조개껍데기와 수도사》, 장 비고의 《품행영점》, 장 콕토의 《시인의 피》, 만 레이의 《인산인해》 등은 그 대표적인 작품으로 논의를 일으켰다.
안달루시아의_개	루이스_부뉴엘	director	 그 중에도  << _obj_ >> 의 《 << _sbj_ >> 》, 《황금시대》, 제르메느 뒬라크의 《조개껍데기와 수도사》, 장 비고의 《품행영점》, 장 콕토의 《시인의 피》, 만 레이의 《인산인해》 등은 그 대표적인 작품으로 논의를 일으켰다.
마르크_오버르마르스	FC_바르셀로나	team	 정확한 패스와 슈팅 능력이 돋보이던 로베르 피레스는  << _obj_ >> 로 떠난  << _sbj_ >> 의 공백을 메우기 위해 2000년 여름, 프리미어리그의 아스널 FC로 이적하여 왔다.
이강석_(스피드_스케이팅_선수)	대한민국	country	 2006년 시즌 후 잠시 휴식기를 가진 후 2007년 ~ 2008년 시즌에 복귀하여 2007년 11월 미국 솔트레이크시티에서 열린 월드컵 대회 500m에서 34.03초의 기록으로  << _obj_ >> 의  << _sbj_ >> 이 보유하고 있던 500m 세계 신기록을 경신하며 전성기를 되찾았다.
룹알할리_사막	사우디아라비아	country	 1900년대 들어서 아라비아영양의 서식지는 줄어들기 시작했고  << _obj_ >>  북서부의 네푸드 사막과 남부의  << _sbj_ >> 이 이들의 마지막 서식지가 되었다가, 동물원에서 계보가 끊긴 아라비아영양의 야생종을 복원하기 시작했으며 재도입이 성공적으로 이루어져, 현재는 오만, 사우디아라비아 등 아라비아 반도의 사막 및 초원 지역에 서식한다.
GMA_네트워크	필리핀	country	이 곡은 1983년부터 1996년까지  << _obj_ >>  멀티미디어 그룹의 TV 네트워크인  << _sbj_ >> 의 오래된 쇼 프로그램 "Lovingly Yours, Helen"에서 오프닝과 나레이션 테마음악으로 사용되기도 했는데, 이 프로그램은 최초인 1981년에 일요일 오후 라디오 드라마 모음집으로 시작되어 인기를 끌면서 1983년 TV 드라마 시리즈로까지 확대된 프로그램이며 헬렌 벨라가 진행했다.
김기태_(1969년)	KIA_타이거즈	team	하지만 2011년  << _obj_ >> 가 준 플레이오프에서 SK 와이번스에 1승 3패로 패하여 플레이오프 진출이 좌절되면서 조범현 감독이 경질되었고, 조범현 사단의 해체와 동시에 선동열이 새로 감독에 부임하자 옛 쌍방울 레이더스 선배였던  << _sbj_ >>  감독의 부름을 받아 LG 트윈스로 옮겼다.
아가씨	박찬욱	director	2016년, 김민희는  << _obj_ >>  감독의 영화 《 << _sbj_ >> 》의 주연으로 발탁 되어 배우 하정우, 김태리와 호흡을 맞췄다.
라플라타_강	아르헨티나	country	탱고는  << _obj_ >> 와 우루과이 사이를 흐르는  << _sbj_ >>  유역 몬테비데오, 부에노스아이레스 두 도시의 주변에서 생성된 음악이다.
라티나_현	이탈리아	country	라티나는  << _obj_ >>  라치오 주  << _sbj_ >> 에 위치한 코무네다.
반노차_카타네이	루크레치아_보르자	child	호프레 보르자 또는 조프레 보르자는 스퀼라체 공작으로, 교황 알렉산데르 6세와  << _sbj_ >>  사이에서 태어난 자녀 가운데 막내아들이며, 체사레 보르자, 후안 보르자,  << _obj_ >> 와 남매지간이다.
시민_케인	오손_웰스	director	한때 천재 감독  << _obj_ >> 의 영화 〈 << _sbj_ >> 〉에서 풍자되기도 했으며 미국 캘리포니아 주에는 그가 건설한 거대한 허스트 캐슬이 자리잡고 있다.
싸이렌_(2000년_영화)	신현준_(배우)	starring	 다음 작품인 《반칙왕》에는 장항선 의 딸이자 트레이너인 장민영 역으로 출연했고, 《 << _sbj_ >> 》에는  << _obj_ >> 의 연인 하예린 역으로 출연했다.
오버_더_레인보우_(영화)	이정재_(배우)	starring	 장진영은 다음 작품인 로맨스 영화 《 << _sbj_ >> 》에서  << _obj_ >> 의 상대역인 강연희를 연기했고, 김하인의 동명 소설을 원작으로 한 멜로 영화 《국화꽃 향기 》에서는 박해일의 상대역으로 아이를 낳고 죽음을 맞는 위암 환자 민희재를 연기했다.
여효진	부산_아이파크	team	2011년 11월 21일, 박희도 와 트레이드되어  << _sbj_ >> 과 함께  << _obj_ >> 로 이적하였다.
레이다르_크바멘	노르웨이_축구_국가대표팀	team	 또한 1936년 하계 올림픽에서  << _obj_ >> 가 동메달을 딸 때에 기여했던  << _sbj_ >> 을 배출하였다.
메나헴_베긴	이스라엘	country	캠프데이비드 협정은 1978년 9월 5일부터 9월 17일까지 미국의 캠프데이비드에서  << _obj_ >> 과 이집트간의 단독평화교섭을 이루기 위한 목적으로 열린 모임 당시 미국 대통령 지미 카터가 주선하여 안와르 사다트 이집트 대통령과  << _sbj_ >>  이스라엘 총리를 초청하였다.
사의_찬미_(영화)	김호선	director	이 실화를 바탕으로 영화 감독  << _obj_ >> 은 영화 《 << _sbj_ >> 》를 제작하였는데, 이 영화는 임성민 과 장미희가 주연을 맡았다.
신동주_(야구인)	삼성_라이온즈	team	 입단 첫 해 김응용 감독의 총애를 받아 김응용 감독이 2001년  << _obj_ >> 에 부임하게 되었을 때 외야수  << _sbj_ >> 를 상대로 트레이드되어 고향 팀에 들어오게 되었다.
박종진_(1987년)	강원_FC	team	2010년 여름 이적 시장에서  << _obj_ >> 의  << _sbj_ >> 과 트레이드 되었고, 8월 14일, 대전 시티즌과의 경기에서 첫 골을 기록해 2 대 1 승리에 기여했다.
거짓말_(2000년_영화)	장선우	director	《 << _sbj_ >> 》은 2000년에 개봉한  << _obj_ >>  감독의 영화이다.
황금광시대	찰리_채플린	starring	《 << _sbj_ >> 》 -  << _obj_ >>  제작, 감독, 주연
황금광시대	찰리_채플린	director	《 << _sbj_ >> 》 -  << _obj_ >>  제작, 감독, 주연
아돌프_히틀러	독일_제국	country	 독일에서는  << _obj_ >> 이 신성로마제국의 계승자를 자처하며 '제2제국'으로 불렸으며,  << _sbj_ >> 의 독일은 '제3제국'으로 불린다.
훌라구	아바카	child	사실 일 한국 왕조는 1260년 이후  << _sbj_ >> ,  << _obj_ >>  등은 킵차크 한국과 아제르바이잔 지역에서 차가타이 한국과는 호라산 지역의 국경지역 분쟁에 신경을 썼기에 바이바르스가 지배하던 시리아 국경지역 침공에는 후속 대책만이 되풀이되었다.
훌라구	아바카	successor	사실 일 한국 왕조는 1260년 이후  << _sbj_ >> ,  << _obj_ >>  등은 킵차크 한국과 아제르바이잔 지역에서 차가타이 한국과는 호라산 지역의 국경지역 분쟁에 신경을 썼기에 바이바르스가 지배하던 시리아 국경지역 침공에는 후속 대책만이 되풀이되었다.
연인들_(시트콤)	이윤성_(배우)	starring	2001년 드라마와 시트콤으로 다시 방송 복귀 후, 시트콤  << _sbj_ >> 에서 인연이 닿은  << _obj_ >> 과 만나 2002년 10월 17일 혼인했다.
주형광	롯데_자이언츠	team	  << _sbj_ >>  현  << _obj_ >>  코치를 동경하였던 그는 연고 팀이었던 롯데 자이언츠로 가기를 원했으나, 롯데 자이언츠는 좌투수 장원준 을 지명하였다.
지쿠	브라질_축구_국가대표팀	team	 또 이 구단은 과거  << _obj_ >> 을 대표하는 스타들이었던 자갈루, 지지뉴, 가린샤,  << _sbj_ >> , 소크라치스, 호마리우 등이 거쳐간 구단으로 유명하며, 리우데자네이루뿐만 아니라, 브라질에서도 가장 인기있는 구단으로 알려져 있다.
임효성	인천_전자랜드_엘리펀츠	team	당시  << _obj_ >>  농구단 소속의 농구 선수  << _sbj_ >> 과의 열애소식을 발표하였고, 2010년 2월 24일 두사람의 웨딩사진이 공개되었다.
데이비드_벤틀리	잉글랜드_축구_국가대표팀	team	그러나, 아그본라호르가 스페인의  << _obj_ >>  캠프에서 이탈하자, 스튜어트 피어스 감독은 그를 잉글랜드의 U-21 챔피언십 선수 명단에서 제외시켰으며,  << _sbj_ >> 가 그를 대신할 선수로 발탁되었다.
GM대우_스테이츠맨	GM대우_베리타스	successor	 현재는 GM대우 라세티 에 장착되는 1.8리터 에코텍 엔진과 GM대우 윈스톰의 2.4리터 엔진, 수출용 GM대우 윈스톰 의 V6 3.2리터 가솔린 엔진을 공급하며 대형차  << _sbj_ >>  과  << _obj_ >>  는 홀덴의 사우스오스트레일리아 주 엘리자베스  공장에서 대한민국형으로 만들어 OEM 방식으로 들여오기도 했다.
사랑한다면_이들처럼	이동건	starring	 그 후 2007년 2월,  << _obj_ >> 과 함께 자신의 소속사 엠넷미디어에서 제작한 《 << _sbj_ >> 》 이라는 제목의 4부작 뮤직 드라마에 출연하였다.
위험한_관계_(1988년_영화)	글렌_클로스	starring	《 << _sbj_ >> 》. 스티븐 프리어스 감독.  << _obj_ >> , 존 말코비치, 미셸 파이퍼 출연. 햄프턴의 연극에 의한 것이다.
사랑보다_아름다운_유혹_(1999년_영화)	세라_미셸_겔러	starring	《 << _sbj_ >> 》. 로저 컴블 감독.  << _obj_ >> , 라이언 필립, 리즈 위더스푼 출연. 현대사가 배경이다.
김원봉	조선민주주의인민공화국	country	약산은  << _obj_ >> 의 정치인  << _sbj_ >> 의 호이다.
며느리_전성시대	장현성	starring	《 << _sbj_ >> 》에 아버지의 대를 이은 의사 역할로 출연한 배우  << _obj_ >> 은 양택조의 사위이다.
루카스_포돌스키	FC_바이에른_뮌헨	team	 이 팀의 최다 득점자는  << _sbj_ >> 로 12골을 득점하였고, 시즌 종료 후  << _obj_ >> 으로 이적하였다.
스톨레_솔바켄	노르웨이_축구_국가대표팀	team	 이후, 푸스볼-분데스리가 2011-12을 앞두고 전  << _obj_ >>  선수이자 최근에 FC 쾨벤하운 감독직을 사임한  << _sbj_ >> 이 새 사령탑이 되었다.
김지용	LG_트윈스	team	 7월 31일에  << _obj_ >> 와의 경기에서 9회말 1사에서  << _sbj_ >> 이 던진 공을 몸에 맞아 사구로 출루했다.
에비스_(도쿄_도)	일본	country	삿포로 맥주 주식회사는  << _obj_ >> 의 맥주 회사이며, 본사는 도쿄 도  << _sbj_ >> 에 있다.
잔_달브레	앙리_4세	successor	마르그리트의 남편감으로는 스페인 왕 펠리페 2세의 후계자였던 돈 카를로스, 포르투갈의 왕인 세바스티아노 1세 등이 제기되었으나 모두 협상 과정에서 흐지부지되었고, 결국 나바라 왕국의 여왕인  << _sbj_ >> 의 아들이자 후계자로 프랑스 개신교 진영의 수장인  << _obj_ >> 와의 결혼이 확정되었다.
얀_페르통언	벨기에_축구_국가대표팀	team	 전반 44분  << _obj_ >> 의 스테번 드푸르가 김신욱에게 반칙을 범해 퇴장당하여 수적으로 우세한 상황에 놓였음에도 불구하고 고질적인 문제인 골 결정력 부족 등으로 수적 우위를 제대로 살리지 못하여 후반 33분  << _sbj_ >> 에게 결승골을 허용하며 0 - 1로 아쉽게 패배하였다.
프란체스코_1세_스포르차	갈레아초_마리아_스포르차	successor	 이들 유물 중에는 비스콘티 가문의 조반니 마리아 비스콘티와 바르나보 비스콘티와 필리포 마리아 비스콘티, 스포르차 가문의  << _sbj_ >> 와 그의 부인 비앙카,  << _obj_ >> 와 루도비코 스포르차 등의 무덤이 있는데, 이들 무덤이 어디로 옮겨졌는지는 확실하지 않다.
윌트_체임벌린	필라델피아_세븐티식서스	team	 하지만 셀틱스는 동부 컨퍼런스 파이널에서  << _sbj_ >> 의  << _obj_ >> 에게 무너져 9연패에 실패하고 말았다.
카림_압둘_자바	밀워키_벅스	team	1974년 NBA 파이널에 올라간 셀틱스는  << _sbj_ >> 가 이끄는  << _obj_ >> 를 7차전까지 가는 끝에 꺾고 열두번째 우승을 차지하게 된다.
로버트_패리시	골든스테이트_워리어스	team	 시즌 후, 아워벡은  << _obj_ >> 로부터  << _sbj_ >> 와 1라운드 지명권을 얻었고, 전체 3순위로 케빈 맥헤일을 지명했다.
몽정기	김선아	starring	《엽기적인 그녀》의 차태현과 《 << _sbj_ >> 》의  << _obj_ >> 가 출연하였다.
다리우스_1세	크세르크세스_1세	successor	리비아는 페르시아의  << _sbj_ >> 의 낙셰 루스탐과  << _obj_ >> 의 다이바 비문에 따르면 아케메네스 제국의 태수령였다.
묘조_식품	일본	country	 이 제품은 삼양식품의 설립자인 전중윤 회장이  << _obj_ >> 의 《 << _sbj_ >> 》에서 라면 기계 2대를 들여서 생산하기 시작하였다.
미키_맨틀	뉴욕_양키스	team	 이것은 메이저 리그 베이스볼인  << _obj_ >> 의  << _sbj_ >> 과 로저 메리스를 MM포에 비유했다.
BP_(기업)	영국	country	 현재는  << _obj_ >>   << _sbj_ >> 의 계열사이다.
하석주	대한민국_축구_국가대표팀	team	2번째 멤버는  << _obj_ >> 의  << _sbj_ >> 로 1998년 FIFA 월드컵 조별예선 멕시코 축구 국가대표팀전에서 전반 프리킥 으로 선제골을 넣었으나 백태클 반칙으로 퇴장당해 36년 만에 가힌샤를 제외한 첫 멤버가 되었다.
히가시무라야마_시	일본	country	도쿄 성서학원은  << _obj_ >>  도쿄 도  << _sbj_ >> 에 있는 성결교 계통의 학교이다.
칭기즈_칸	우구데이_칸	successor	귀위크가 아직 회군 길이던 1241년 12월, 우구데이는 카라코룸에서 죽었으며 당시 몽골 제국의 칸들이 모두 부재 중이었는데, 이 틈에  << _obj_ >> 의 친 숙부이자  << _sbj_ >> 의 동복 막내아우 이며 73세 고령의 옷치킨 가 군사를 이끌고 우구데이의 로 접근했다.
알크마르	네덜란드	country	AFAS 스타디온, 옛 이름 DSB 스타디온은 다목적 경기장으로  << _obj_ >> 의  << _sbj_ >> 에 위치해 있다.
세르히오_라모스	세비야_FC	team	 그는 마드리드 연고 구단에 처음 7년 동안 선발로 출전했지만, 라리가 2006-07에 들어  << _obj_ >> 에서 건너온  << _sbj_ >> 에 의해 후보로 밀려났다.
호르헤_이과인	스타드_브레스트_29	team	이과인은 1987년 12월 10일, 프랑스의 브레스트 에서 당시  << _obj_ >> 로 활약하던 아르헨티나 축구 선수인  << _sbj_ >> 의 아들로 출생했다.
호세_마누엘_레이나	리버풀_FC	team	 이과인은 이적설의 중심에 있었고, 다수의 언론은 아스널 이적 소문을 보도했지만 아우렐리오 데 라우렌티스 나폴리 회장이  << _obj_ >>  골키퍼  << _sbj_ >> 와 함께 의료 검진을 통과했다고 발표하며 사태가 종료되었고, 아르헨티나인은 이탈리아 구단과 5년 계약을 맺고 유로40M에 이적했다.
로베르트_후트	미들즈브러_FC	team	시즌 첫 자책골 :  << _obj_ >> 의  << _sbj_ >>  
미하엘_발라크	바이어_04_레버쿠젠	team	 1999년,  << _obj_ >> 으로 이적하였으며, 주전 자리를 꿰차고,  << _sbj_ >> , 옌스 노보트니와 함께 팀의 주축 선수로 활동하면서, 1999-00 시즌과 2001-02 시즌의 분데스리가 준우승, 2001-02 시즌의 UEFA 챔피언스리그 준우승에 공헌하였다.
고용희	김여정	child	재일교포 무용수 출신  << _sbj_ >> 와의 사이에서는 김정철 , 김정은 형제와 딸  << _obj_ >> 이 있다.
손흥민	함부르크_SV	team	대한민국의 축구 선수  << _sbj_ >>   << _obj_ >> ).
오히라_마사요시	일본	country	1965년 6월, 당시  << _obj_ >>  외무상인  << _sbj_ >> 와의 비밀 접촉으로 '김종필·오히라 메모'에 합의해 협정 체결에 결정적인 공헌을 했으나 이 과정에서 식민지배에 대한 사과, 약탈 문화재 반환, 재일동포 지위, 동해어업권, 강제 동원 피해자 보상, 원폭피해자 문제 등 주요 현안은 모조리 무시한 채 경제적 보상과 차관을 대가로 모든 문제의 종결을 선언해버려 이 후 한일 관계에 계속되는 문제점과 야당 인사들의 반발을 초래했다.
툴라_(러시아)	러시아	country	톨스토이는 1828년 9월 9일에  << _obj_ >>  남부  << _sbj_ >>  근처의 야스나야 폴랴나에서 태어났다.
식코	마이클_무어	starring	 이것은  << _obj_ >>  감독의 영화 《 << _sbj_ >> 》에서 소개되기도 하였다.
식코	마이클_무어	director	 이것은  << _obj_ >>  감독의 영화 《 << _sbj_ >> 》에서 소개되기도 하였다.
호찌민	팜반동	successor	구 월맹은 1969년  << _sbj_ >> 이 세상을 떠난 뒤 쯔엉찐 국민의회상임위 의장, 레주언 베트남 공산당 제1서기,  << _obj_ >>  수상 등 3인을 중심으로 집단지도 체제를 채택했다.
황야의_무법자	세르조_레오네	director	‘좋은 놈, 나쁜 놈, 이상한 놈’이란 제목은  << _obj_ >>  감독의 1966년작  << _sbj_ >> 의 오마주이다.
가온_차트_K-POP_어워드	대한민국	country	"라는 말을 남기는 등  << _obj_ >> 과 많은 인연이 있으며, 대한민국의 공인 음반 차트인 가온 차트에서 주최하는  << _sbj_ >> 에서 지금까지 네 번 수상할 만큼 국내에서의 인지도가 상당하고 "국민 밴드"라는 호칭도 얻었다.
Mr._로빈_꼬시기	엄정화	starring	신도영 역 물망에 한때 거론되기도 했던  << _obj_ >> 는 MBC 환상의 커플에서 조안나 역으로 낙점되었으나 음반 활동과 영화  << _sbj_ >>  촬영 스케줄 문제로 고사했으며 환상의 커플은 엄정화 외에도 이하나의 학교 선배인 김현주  뿐 아니라 최강희  등이 조안나 역에 거론되기도 했는데 이들 중 이하나와 최강희 는 KBS 2TV 공부의 신 여주인공 물망에 오른 바 있었다.
펠릭스_에르난데스	시애틀_매리너스	team	이적 2일 후인 7월 29일에는 전 소속 팀  << _obj_ >> 과의 홈 경기에서 시애틀 에이스  << _sbj_ >> 의 직구를 받아쳐 1-0으로 승부를 짓는 결승 솔로 홈런을 만들어냈다.
도쿠가와_이에나리	도쿠가와_이에요시	successor	1817년부터 1846년까지 재위하는 동안 1817년부터 1837년까지  << _sbj_ >> 가 섭정하였고 1837년부터 1846년 붕어할 때까지  << _obj_ >> 가 대리청정하였다.
미나모토노_요리토모	미나모토노_요리이에	child	 초대 쇼군  << _sbj_ >> 의 차남으로 2대 쇼군인 형  << _obj_ >> 가 쫓겨난 뒤 외가 친척인 호조씨에 의해 옹립됐다.
미나모토노_요리토모	미나모토노_요리이에	successor	 초대 쇼군  << _sbj_ >> 의 차남으로 2대 쇼군인 형  << _obj_ >> 가 쫓겨난 뒤 외가 친척인 호조씨에 의해 옹립됐다.
당_헌종	당_목종	successor	 백거이는 810년에  << _sbj_ >> 이 신라의 헌덕왕에게 보내는 국서를 황제를 대신해 지었으며, 821년에서 822년 사이에 신라에서 온 하정사 김충량이 귀국할 때  << _obj_ >> 이 내린 제서도 그가 지었다.
고후시미_천황	고니조_천황	successor	천황 :  << _sbj_ >> ,  << _obj_ >>
투르네	벨기에	country	카스테르만""은 1776년 도나 카스테르만""이  << _obj_ >>   << _sbj_ >> 에 설립한 것을 시초로, 현재 프랑스 파리 시와 벨기에 투르네에 거점을 두고 있는 세계의 유명 만화들의 판권을 가지고 있는 출판사이다.
오토_2세	오토_3세	successor	 그는 신성 로마 제국 황제  << _sbj_ >> ,  << _obj_ >>  그리고 랭스의 대주교 아달베롱와 연합하여 카롤링거 왕조의 프랑스의 로테르에게 대항하였다.
앨런_시어러	사우샘프턴_FC	team	 최초의 300만 파운드 이적료는 첫 프리미어리그 시즌 전인 1992년 7월에  << _obj_ >> 에서 블랙번 로버스 FC로 이적한  << _sbj_ >> 가 기록하였다.
슬라벤_빌리치	크로아티아_축구_국가대표팀	team	 그는  << _obj_ >> 와의 1998년 FIFA 월드컵#준결승전에서  << _sbj_ >> 를 팔꿈치로 가격한 것으로 판정되어 퇴장  명령이 내려졌고, 1998년 FIFA 월드컵 결승전에 결장하였다.
허브드	몽골	country	허브드 주는  << _obj_ >>  서부에 위치한 주로 주도는  << _sbj_ >> 이며 면적은 76,060.38㎢, 인구는 76,870명이다.
사인샨드	몽골	country	더르너고비 주는  << _obj_ >>  남동부에 위치한 주로 주도는  << _sbj_ >> 이며 면적은 109,472.30㎢, 인구는 58,612명이다.
블라디미르_베스차스트니흐	러시아_축구_국가대표팀	team	그는 현재,  << _obj_ >>  선수중에서, 2014년 9월 3일, 러시아 힘키의 아레나 힘키 에서 열린 아제르바이잔 축구 국가대표팀과의 경기에서, 2골을 추가로 득점하며, 28골로,A매치 26골을 득점한  << _sbj_ >>  를 제치고, 역대 러시아 축구선수중, 가장 많은 득점을 하여 러시아 최고의 공격수라는 명예에 올랐으며, 이 기록은 자신에 의해 계속 신기록이 수립되고있다.
헤라트_주	아프가니스탄	country	헤라트는 서부  << _obj_ >> 의  << _sbj_ >> 의 주도이다.
콘스탄티누스_10세	로마누스_4세	successor	니케포루스 보타네이아테스는 소아시아의 유력한 군사귀족 출신으로  << _sbj_ >>  및  << _obj_ >>  황제 시기에 제국의 장군으로 복무했다.
라힘쿨로프_칸	무함마드_아민_칸	child	2차 온기라트 왕조 시대의 건축물부터는 예술성을 갖추기 시작하여  << _sbj_ >> 이 세운 하자라스 궁전에 대하여  << _obj_ >> 은 유럽에서 방문한 사람들에게 놀라움을 주었다고 기록했다.
라힘쿨로프_칸	무함마드_아민_칸	successor	2차 온기라트 왕조 시대의 건축물부터는 예술성을 갖추기 시작하여  << _sbj_ >> 이 세운 하자라스 궁전에 대하여  << _obj_ >> 은 유럽에서 방문한 사람들에게 놀라움을 주었다고 기록했다.
파에타노	산마리노	country	SC 파에타노는  << _sbj_ >> 를 연고로 하는  << _obj_ >> 의 축구 클럽이다.
겨울왕국	조시_개드	starring	 2013년 공개된 《 << _sbj_ >> 》 시리즈의 단편 영화로,  << _obj_ >> , 크리스틴 벨, 이디나 멘젤, 조너선 그로프가 목소리 출연한다.
레드_소냐	브리짓_닐센	starring	 2011년, 《콤플렉스》는 쿠니스가 열 번째로 잘못 캐스팅된 영화 영웅으로 선정한 뒤 "그의 캐릭터 모나 색스는 러시아의 암살자로,  << _obj_ >> 이 《 << _sbj_ >> 》 시절 보여준 아마존 여성을 상기시킨다.
필리프_페탱	프랑스_제3공화국	country	 이들은  << _obj_ >> 의 민주주의, 자유주의를 위협하는 가장 강력한 세력으로  << _sbj_ >>  원수의 민족혁명과 르펜의 민족전선의 선구자로 여겨진다.
그라다차츠	보스니아_헤르체고비나	country	NK 즈비예즈다 그라다차츠는  << _sbj_ >> 를 연고로 하는  << _obj_ >> 의 축구 클럽이다.
더_독	이연걸	starring	 이후 2005년  << _obj_ >>  주연의  << _sbj_ >>  사운드트랙과 영국 인디 영화 불렛 보이 사운드트랙에 참여했다.
아비정전	장국영	starring	 2011년에는 구스 반 산트의 밀크, 자비에 돌란의 하트비트 외 3편, 2012년에는 페드로 알모도바르의 내가 사는 피부, 톰 티크베어의 쓰리 외 3편을 상영하였고, 2013년에는  << _obj_ >>  특별전을 통해  << _sbj_ >> , 천녀유혼 등을 소개했다.
시우다드후아레스	멕시코	country	 최종 예선은 2008년 4월 2일부터 4월 9일까지  << _obj_ >>   << _sbj_ >> 에서 열렸다.
비엔_주	프랑스	country	쇼비니는  << _obj_ >>  푸아투샤랑트  << _sbj_ >> 에 위치한 도시로 면적은 95.82㎢, 인구는 7,050명, 인구 밀도는 74명/㎢이다.
북바치카_구	세르비아	country	바치카토폴라는  << _obj_ >>  보이보디나 자치주의  << _sbj_ >> 에 위치한 도시로 면적은 596㎢, 인구는 33,321명이다.
아레초_현	이탈리아	country	코르토나는  << _obj_ >>  토스카나 주  << _sbj_ >> 에 위치한 코무네로 면적은 343㎢, 높이는 494m, 인구는 22,526명, 인구 밀도는 66명/㎢이다.
배리_지토	오클랜드_애슬레틱스	team	1999~2016년의  << _obj_ >>  MLB 3대 투수: 팀 허드슨, 마크 멀더,  << _sbj_ >>
UEFA_슈퍼컵_2017	UEFA_챔피언스리그_2016-17	team	이 경기의 승리 팀은  << _sbj_ >> 에서  << _obj_ >>  우승 팀과 경기를 펼친다.
시드니_올림픽_공원	오스트레일리아	country	스타디움 오스트레일리아는  << _obj_ >>  뉴사우스웨일스 주 시드니 홈부쉬 지역의  << _sbj_ >> 에 위치한 다목적 경기장이다.
모라_(스웨덴)	스웨덴	country	모라 시는  << _obj_ >>  달라르나 주에 위치한 지방 자치체로 행정 중심지는  << _sbj_ >> 이며 면적은 3,111.54㎢, 인구는 20,279명, 인구 밀도는 6.5명/㎢이다.
롤란_섬	덴마크	country	남쪽으로는 독일 연안, 서쪽으로는 윌란 반도, 북쪽으로는  << _obj_ >>   << _sbj_ >> , 팔스테르 섬, 묀 섬, 동쪽으로는 발트 해와 접한다.
훗사_시	일본	country	구마가와 역은  << _obj_ >>  도쿄 도  << _sbj_ >> 에 위치한 동일본 여객철도 이쓰카이치 선의 철도역이다.
아스콜리피체노_현	이탈리아	country	산베네데토델트론토는  << _obj_ >>  마르케 주  << _sbj_ >> 에 위치한 코무네로 면적은 25㎢, 높이는 7m, 인구는 48,700명, 인구 밀도는 1,900명/㎢이다.
안효연	부산_아이파크	team	 결국 2005년 타 팀으로의 이적을 추진하여 전북 현대 모터스로의 이적이 확실시되었으나 고창현과 함께  << _sbj_ >> 과의 맞트레이드로  << _obj_ >> 로 이적하게 되었고, 자신이 원하지 않는 구단으로 이적하게 되자 훈련을 잘 이행하지 않는 등의 불성실한 태도를 보이며 자신의 이적을 요구하였다.
RCTI	인도네시아	country	 그러나 이슬람권 국가 중에서 프로그램 참여 방송국에 이름을 올린 국가가 아주 없진 않았으며, 대표적으로 이집트의 이집트의 통신와  << _obj_ >> 의  << _sbj_ >>  등이 참여했다.
두바이_토후국	아랍에미리트	country	하타는  << _obj_ >>   << _sbj_ >> 에 위치한 도시로 높이는 330m이다.
하프_넬슨	라이언_플렉	director	 주로 동료  << _obj_ >>  감독 협업하며, 그와 같이 연출한 작품으로 《 << _sbj_ >> 》, 《미시시피 그라인드》가 있다.
마그니토고르스크	러시아	country	1951년 2월 2일  << _obj_ >>   << _sbj_ >> 의 우크라이나계 가정에서 태어났으며, 아버지는 볼로디미르 빌리, 어머니는 지나이다 미하일리우나였다.
알자라_주	쿠웨이트	country	알자라는  << _obj_ >>   << _sbj_ >> 의 주도로 인구는 393,432명이다.
코니아일랜드	미국	country	 영화의 배경은 1950년대 후반  << _obj_ >>   << _sbj_ >> 의 놀이공원이다.
토파즈_(1969년_영화)	앨프리드_히치콕	director	  << _obj_ >>  감독의 영화 《 << _sbj_ >> 》에서는 후아니타 역을 맡았다.
김택형	넥센_히어로즈	team	이후 5월 18일에  << _sbj_ >> 과의 1:1 트레이드로  << _obj_ >> 로 이적하였다.
대니_콜린스_(영화)	댄_포글먼	director	 이외에 킴벌리 피어스 감독의 《캐리 》,  << _obj_ >>  감독의 《 << _sbj_ >> 》, 브래드 페이턴 감독의 《샌 안드레아스 》 등의 영화에도 참여했다.
용담공_필리프	용맹공_장	successor	앙투안은  << _sbj_ >> 와 마르그리트 3세 드 플랑드르의 아들로 태어났고  << _obj_ >> 의 형제였다.
라미아_(도시)	그리스	country	 행정 구역 상으로는  << _obj_ >>  중앙그리스 주 프티오티다 현  << _sbj_ >> 에 속한다.
로건_(영화)	보이드_홀브룩	starring	영화 《 << _sbj_ >> 》에서는  << _obj_ >> 이 도널드 피어스를 연기했다.
본_(프랑스)	프랑스	country	유럽 고속도로 17호선 은 벨기에 안트베르펜을 기점으로  << _obj_ >>   << _sbj_ >> 을 종점으로 하는 유럽 고속도로이다.
앤드루_콜린_렌프루	영국	country	아나톨리아 가설은 1987년  << _obj_ >>  고고학자  << _sbj_ >> 가 처음 주장한 신석기 시대 아나톨리아에서 비롯된 원시 인도유럽인에 의해 확산되었다는 가설이다.
닛산_캐시카이	닛산_X-트레일	successor	르노삼성 QM5는 대한민국의 자동차 업체인 르노삼성자동차의 첫 스포츠 유틸리티 자동차로,  << _sbj_ >> 와 닛산 로그 그리고  << _obj_ >> 의 플랫폼을 공유하여 개발됐다.
에두아르두_다_시우바	아스널_FC	team	그는 2008년 2월 23일  << _obj_ >> 과의 경기에서  << _sbj_ >> 의 정강이에 강한 태클을 걸어, 심각한 개방성 골절을 입힌 바 있다.
컨택트_(영화)	드니_빌뇌브	director	 스티브 매퀸 감독의 《헝거 》, 《셰임 》 《노예 12년》,  << _obj_ >>  감독의 《》, 《 << _sbj_ >> 》 등을 작업했다.
메드닌	튀니지	country	메드닌 전투는 1943년 3월 6일  << _obj_ >>   << _sbj_ >> 에서 일어난 제2차 세계 대전의 튀니지 전역의 전투이다.
쥬랜더	벤_스틸러	starring	 이후 독립영화 《세이프 맨》을 1998년 선댄스에서 선보였고, 《미트 페어런츠》와 《 << _sbj_ >> 》의 시나리오를 맡아 제이 로치,  << _obj_ >>  등과 인연을 맺었다.
쥬랜더	벤_스틸러	director	 이후 독립영화 《세이프 맨》을 1998년 선댄스에서 선보였고, 《미트 페어런츠》와 《 << _sbj_ >> 》의 시나리오를 맡아 제이 로치,  << _obj_ >>  등과 인연을 맺었다.
러시아워_(영화)	브렛_래트너	director	애덤 그린버그은 폴란드와 이스라엘 출신의 영화 촬영 기사로, 제임스 캐머런의 터미네이터 이부작을 비롯 제리 저커 감독의 《사랑과 영혼》, 에밀 아르돌리노 감독의 《시스터 액트》,  << _obj_ >>  감독의 《 << _sbj_ >> 》 등의 영화가 대표작이다.
라이프_오브_파이	리안	director	 데이비드 핀처 감독의 《벤자민 버튼의 시간은 거꾸로 간다》,  << _obj_ >>  감독의 《 << _sbj_ >> 》의 촬영 감독을 담당했고, 《라이프 오브 파이》로 2012년 아카데미 촬영상을 받았다.
머니볼_(영화)	베넷_밀러	director	 놀런 감독 작품 외에는 F. 게리 그레이 감독의 《이탈리안 잡 》과  << _obj_ >>  감독의 《 << _sbj_ >> 》이 있다.
이탈리안_잡_(2003년_영화)	F._게리_그레이	director	 놀런 감독 작품 외에는  << _obj_ >>  감독의 《 << _sbj_ >> 》과 베넷 밀러 감독의 《머니볼 》이 있다.
아가_정	일본	country	히가시게조 역은  << _obj_ >>  니가타 현 히가시칸바라 군  << _sbj_ >> 에 위치한 동일본 여객철도 반에쓰사이 선의 철도역이다.
캐스트_어웨이	로버트_저메키스	director	  << _obj_ >>  감독의 영화 《포레스트 검프》로 아카데미 촬영상 후보에 올랐고, 이후 《콘택트 》, 《 << _sbj_ >> 》, 《폴라 익스프레스》, 《얼라이드》까지 저메키스의 작품 촬영을 담당했다.
스즈키_게이타	일본_축구_국가대표팀	team	 2008년 2월 20일 충칭에서 열린  << _obj_ >> 과의 2008년 동아시아컵 경기에서  << _sbj_ >> 와의 몸싸움 도중 그의 멱살을 잡아 양 팀 선수들이 난투극 직전까지 가는 상황이 발생하였으며, 경기 후 일본축구협회가 중화인민공화국 축구 협회에 항의 서한을 전달하기도 하였다.
순수의_시대_(2015년_영화)	강하늘	starring	신인배우 :  << _obj_ >> , 변요한 - 《쎄시봉 》《 << _sbj_ >> 》《스물 》, 《소셜포비아》《마돈나 》
좋아해줘	유아인	starring	남자배우 :  << _obj_ >>  - 《 << _sbj_ >> 》
지우베르투_시우바	아스널_FC	team	2008년의 대변혁 후, 파나티나이코스는 헹크 텐 카터를 감독으로 내정해  << _obj_ >> 의  << _sbj_ >> 와 플루미넨시 FC의 가브리에우 호드리게스 두스 산투스와 같은 고액의 선수들을 영입했다.
김태수_(축구_선수)	인천_유나이티드_FC	team	반면 새로운 선수로 가장 먼저  << _obj_ >> 로부터 베테랑 미드필더  << _sbj_ >> 를 영입했다.
고민혁	울산_현대	team	 같은 날  << _obj_ >> 로부터 미드필더  << _sbj_ >> 을 영입하기도 하였다.
키코_카시야	레알_마드리드_카스티야	team	 카를로스 산체스 가르시아와 다비드 코베뇨의 방출로, 그는  << _obj_ >> 의 주전 선수였고, 안토니오 아단이 그의 후보였으며,  << _sbj_ >> 가 그들 둘의 뒤를 맡았고, 결국 카스티야의 주장 도 맡았다.
걱정하지마	윤다훈	starring	2006년에는 자신의 첫 주연작인 KBS 제2TV 한국방송공사 아침드라마《 << _sbj_ >> 》에 김성령,  << _obj_ >> , 김지완 과 함께 주연으로 출연하였다.
미우나_고우나	한지혜	starring	이후에는 김지석 ,  << _obj_ >> , 조동혁, 유인영, 이상윤 과 함께 KBS 일일연속극 《 << _sbj_ >> 》에서 조동혁이 연기한 나선재의 옛 애인이자 이상윤이 연기한 서우진과 새로운 사랑을 키워나가는 동물병원 수의사인 황지영을 연기했다.
스타의_연인	유지태	starring	 이후 최지우,  << _obj_ >> , 이기우 , 차예련이 출연한 SBS 미니시리즈 《 << _sbj_ >> 》에 여대생으로 카메오 출연하였고, 그 해 5월부터 10월까지 희극인 유세윤과 함께 MBC의 예능 프로그램 《행복주식회사》의 진행자를 맡았다.
아름다운_그대에게_(드라마)	김지원_(1992년)	starring	 이후 일본의 만화가 나카조 히사야의 동명의 순정 만화를 원작으로 하는 설리 , 민호, 이현우 ,  << _obj_ >> 이 주연을 맡은 SBS 미니시리즈 《 << _sbj_ >> 》에 극 중의 학교 지니 남자체육고등학교의 유일한 여교사인 국어교사 이소정 역으로 출연했다.
더_이상은_못_참아	김진우_(1983년_7월)	starring	2013년 여름에는 백일섭, 선우용녀,  << _obj_ >> 와 함께 JTBC의 JTBC 일일연속극 《 << _sbj_ >> 》에 출연하여 황종갑과 길복자의 늦둥이 막내딸이자 중학교 영어교사인 황선주를 연기하였다.
더_이상은_못_참아	백일섭	starring	2013년 여름에는  << _obj_ >> , 선우용녀, 김진우 와 함께 JTBC의 JTBC 일일연속극 《 << _sbj_ >> 》에 출연하여 황종갑과 길복자의 늦둥이 막내딸이자 중학교 영어교사인 황선주를 연기하였다.
갑동이	김민정_(배우)	starring	 2014년에는 1980년대와 1990년대에 대한민국을 뒤흔든 화성 연쇄 살인 사건에서 영감을 받은 윤상현 , 성동일,  << _obj_ >> , 이준 , 김지원  주연의 tvN의 범죄 금토드라마 《 << _sbj_ >> 》에서 이준이 연기한 살인마 류태오에게 희생된 짚공예가 순심 역으로 출연했다.
아메리칸_셰프	존_패브로	starring	 앨런 테일러 감독의 드라마 《왕좌의 게임》과 영화 《》, 《터미네이터 제니시스》,  << _obj_ >>  감독의 《 << _sbj_ >> 》의 촬영 감독으로 일했다.
아메리칸_셰프	존_패브로	director	 앨런 테일러 감독의 드라마 《왕좌의 게임》과 영화 《》, 《터미네이터 제니시스》,  << _obj_ >>  감독의 《 << _sbj_ >> 》의 촬영 감독으로 일했다.
와호장룡	장쯔이	starring	 충칭 시 출신으로, 영화 《 << _sbj_ >> 》에서  << _obj_ >> 의 상대 스턴트 역으로 데뷔하였다.
스파이_브릿지	스티븐_스필버그	director	 《금발이 너무해》 삼부작과 롭 마셜, 조너선 데미 감독의 작품 일부, 니콜라스 빈딩 레픈 감독의 《드라이브 》,  << _obj_ >>  감독의 《 << _sbj_ >> 》, 데이미언 셔젤 감독의 《라라랜드》 등의 영화를 프로듀싱했다.
다니옐_수바시치	크로아티아_축구_국가대표팀	team	 2016년 6월 21일, 그는  << _obj_ >> 와의 일전에서 페널티킥을 찼지만  << _sbj_ >> 의 손에 걸렸고, 1-2 패배를 막지 못했다.
미션_임파서블_2	오우삼	director	 토니 스콧 감독의 《트루 로맨스》, 《스파이 게임》, 《맨 온 파이어》, 마이클 베이 감독의 《나쁜 녀석들 》, 《아일랜드 》,  << _obj_ >>  감독의 《페이스 오프 》, 《 << _sbj_ >> 》, 그리고 저스틴 린 감독의 분노의 질주 시리즈에서 편집을 담당했다.
위대한_명탐정_바실	론_클레먼츠	director	 월트 디즈니 애니메이션 스튜디오 소속으로서 동료  << _obj_ >> 와 같이 《 << _sbj_ >> 》, 《인어공주 》, 《알라딘 》, 《헤라클레스 》, 《공주와 개구리》, 《모아나》를 만들었다.
헤라클레스_(1997년_영화)	론_클레먼츠	director	 월트 디즈니 애니메이션 스튜디오 소속으로서 동료  << _obj_ >> 와 같이 《위대한 명탐정 바실》, 《인어공주 》, 《알라딘 》, 《 << _sbj_ >> 》, 《공주와 개구리》, 《모아나》를 만들었다.
비우티풀	알레한드로_곤살레스_이냐리투	director	  << _obj_ >>  감독의 초기작 《바벨 》, 《 << _sbj_ >> 》과 커티스 핸슨의 《8마일》, 리안의 《브로크백 마운틴》, 《색, 계》, 벤 애플렉의 《아르고 》, 마틴 스코세이지의 《더 울프 오브 월 스트리트》의 촬영을 담당했다.
파이터_(2010년_영화)	데이비드_O._러셀	director	  << _obj_ >>  감독의 영화 《 << _sbj_ >> 》, 《아메리칸 허슬》의 단역으로 출연했다.
아는_형님	민경훈	starring	 JTBC의 예능 《 << _sbj_ >> 》의 멤버인 김희철 과  << _obj_ >> 의 듀엣곡이다.
발두아즈_주	프랑스	country	루아시앙프랑스는  << _obj_ >>  일드프랑스  << _sbj_ >> 에 위치한 도시로 면적은 14.09㎢, 인구는 2,833명, 인구 밀도는 200명/㎢이다.
훠궈	중화인민공화국	country	샤오훼이양은  << _obj_ >> 의  << _sbj_ >>  전문 체인점이다.
바딘	베트남	country	바딘 광장은  << _obj_ >> , 하노이의  << _sbj_ >>  구역에 있는 광장이다.
발두어_폰_시라흐	아르투어_악스만	successor	 초대 국가청소년지도자는  << _sbj_ >> 이고 그 후임은  << _obj_ >> 이었다.
스노든_(영화)	올리버_스톤	director	 대니 보일의 《28일 후》, 《슬럼독 밀리어네어》, 《127시간》, 라스 폰 트리에의 《안티크라이스트》,  << _obj_ >> 의 《 << _sbj_ >> 》 등의 영화의 촬영을 담당하였다.
뉴캐슬언더라임	스태퍼드셔_주	country	뉴캐슬언더라임 구는 잉글랜드  << _obj_ >> 에 위치한 비도시 자치구로 중심 도시는  << _sbj_ >> 이며 인구는 126,052명, 면적은 211.0㎢이다.
캐넉	잉글랜드	country	캐넉체이스 구는  << _obj_ >>  스태퍼드셔 주에 위치한 비도시 자치구로 중심 도시는  << _sbj_ >> 이며 인구는 98,549명, 면적은 78.9㎢이다.
올모스트_페이머스	캐머런_크로	director	 에드워드 즈윅의 《가을의 전설》, 《라스트 사무라이》, 프랜시스 포드 코폴라의 《잭 》, 테런스 맬릭의 《씬 레드 라인》,  << _obj_ >> 의 《 << _sbj_ >> 》, 벤 애플렉의 《가라, 아이야, 가라》, 셰인 블랙의 《아이언맨 3》 등에서 촬영을 담당하였다.
에핑_(에식스_주)	에식스_주	country	에핑포리스트 구는 잉글랜드  << _obj_ >> 에 위치한 비도시 자치구로 중심 도시는  << _sbj_ >> 이며 인구는 128,777명, 면적은 338.99㎢이다.
헨리크_라르손	FC_바르셀로나	team	이 팀의 대표 선수로는 스웨덴 축구 국가대표팀과  << _obj_ >> , 셀틱 FC 등에서 활약한  << _sbj_ >> 이 있다.
헨리크_라르손	셀틱_FC	team	이 팀의 대표 선수로는 스웨덴 축구 국가대표팀과 FC 바르셀로나,  << _obj_ >>  등에서 활약한  << _sbj_ >> 이 있다.
에일즈베리	버킹엄셔_주	country	에일즈베리베일은 잉글랜드  << _obj_ >> 에 위치한 비도시 자치구로 중심 도시는  << _sbj_ >> 이며 인구는 184,560명, 면적은 902.75㎢이다.
폴_레노	막심_베이강	successor	 이곳에 수용된 인사 중에는 테니스 선수 진 보로트라, 전 총리 에두아르 달라디에와  << _sbj_ >> , 전 참모총장  << _obj_ >> 과 모리스 가믈랭, 샤를 드 골의 누나 마리아녜스 카이오, 우익연맹의 지도자이자 레지스탕스 최측근인 프랑수아 드 라 로크, 프랑스 노동조합 지휘자 레옹 주오 등이 있었다.
폴_레노	에두아르_달라디에	successor	 이곳에 수용된 인사 중에는 테니스 선수 진 보로트라, 전 총리  << _obj_ >> 와  << _sbj_ >> , 전 참모총장 막심 베이강과 모리스 가믈랭, 샤를 드 골의 누나 마리아녜스 카이오, 우익연맹의 지도자이자 레지스탕스 최측근인 프랑수아 드 라 로크, 프랑스 노동조합 지휘자 레옹 주오 등이 있었다.
내셔널_바스켓볼_리그_(미국)	디트로이트_피스턴스	team	 과거 아메리카 농구 협회/ << _sbj_ >> /전미 농구 협회  << _obj_ >> /디트로이트 피스턴스의 홈경기장으로 사용했다.
시데하라_기주로	요시다_시게루	successor	1부 '상징 천황'에서는 헌법문제 담당 대신 마쓰모토 조우지와 공작 고노에 후미마로의 불화를 중심축으로 하여 일본의 내각총리대신  << _sbj_ >> , 일본의 외무대신  << _obj_ >>  등이 활동하던 모습을 그리고 있다.
차두리	FC_서울	team	 최용수 감독은 장쑤의 파격적인 제안에 처음에 흔들린 것은 사실이었지만  << _obj_ >> 과  << _sbj_ >> , 박주영등 자신 때문에 서울에 입단한 선수들과의 의리 때문에 잔류를 택하였다고 밝혔다.
후한_안제	후한_순제	child	채옹은 후한 화제의 묘호인 목종,  << _sbj_ >> 의 묘호 공종,  << _obj_ >> 의 묘호 경종, 후한 환제의 묘호 위종을 모두 없애자고 건의하였으며, 이것이 받아들여져 그대로 시행되었다.
페텐_주	과테말라	country	플로레스는  << _obj_ >>  북부에 위치한 도시로  << _sbj_ >> 의 주도이며 인구는 13,700명이다.
UEFA_챔피언스리그_2010-11	FC_바르셀로나	team	  << _sbj_ >>  우승 팀인  << _obj_ >> 와 UEFA 유로파리그 2010-11 우승 팀인 FC 포르투가 맞붙었다.
윈스턴세일럼	미국	country	캐롤라이나 선더버즈는  << _obj_ >>  노스캐롤라이나 주  << _sbj_ >> 을 연고지로 하는 페더럴 하키 리그 소속 아이스 하키팀( 2017~2018시즌 참가할 예정이다.
그랜_토리노	클린트_이스트우드	starring	  << _obj_ >> 와 함께 하며 《블러드 워크 》를 시작으로 《밀리언 달러 베이비》, 《아버지의 깃발 》, 《이오지마에서 온 편지》, 《 << _sbj_ >> 》 등 그의 대부분의 연출 작품에서 촬영 감독을 담당하고 있다.
그랜_토리노	클린트_이스트우드	director	  << _obj_ >> 와 함께 하며 《블러드 워크 》를 시작으로 《밀리언 달러 베이비》, 《아버지의 깃발 》, 《이오지마에서 온 편지》, 《 << _sbj_ >> 》 등 그의 대부분의 연출 작품에서 촬영 감독을 담당하고 있다.
블러드_워크_(2002년_영화)	클린트_이스트우드	starring	  << _obj_ >> 와 함께 하며 《 << _sbj_ >> 》를 시작으로 《밀리언 달러 베이비》, 《아버지의 깃발 》, 《이오지마에서 온 편지》, 《그랜 토리노》 등 그의 대부분의 연출 작품에서 촬영 감독을 담당하고 있다.
블러드_워크_(2002년_영화)	클린트_이스트우드	director	  << _obj_ >> 와 함께 하며 《 << _sbj_ >> 》를 시작으로 《밀리언 달러 베이비》, 《아버지의 깃발 》, 《이오지마에서 온 편지》, 《그랜 토리노》 등 그의 대부분의 연출 작품에서 촬영 감독을 담당하고 있다.
밀리언_달러_베이비	클린트_이스트우드	starring	  << _obj_ >> 와 함께 하며 《블러드 워크 》를 시작으로 《 << _sbj_ >> 》, 《아버지의 깃발 》, 《이오지마에서 온 편지》, 《그랜 토리노》 등 그의 대부분의 연출 작품에서 촬영 감독을 담당하고 있다.
밀리언_달러_베이비	클린트_이스트우드	director	  << _obj_ >> 와 함께 하며 《블러드 워크 》를 시작으로 《 << _sbj_ >> 》, 《아버지의 깃발 》, 《이오지마에서 온 편지》, 《그랜 토리노》 등 그의 대부분의 연출 작품에서 촬영 감독을 담당하고 있다.
Wii_리모컨	Wii_리모컨	successor	  << _sbj_ >> ,  << _obj_ >> , Wii 밸런스 보드 등의 전작 Wii의 대부분의 주변 기기 하드웨어는 새로운 콘솔과의 동작이 확인되었으며 콘솔은 모든 Wii 및 버추얼 콘솔 타이틀과 하위 호환성이 된다.
하드라마우트_주	예멘	country	  << _obj_ >> 의 토착종으로  << _sbj_ >>  애쉬 샤하르에서 발견된다.
엔리케_카스트로_곤살레스	스포르팅_히혼	team	 그는 그의 유년시절 우상인  << _sbj_ >> 의 발자취를 따라 지역 클럽인  << _obj_ >> 에서 입단하였고, 프로무대에서 대 도약을 하였다.
루이스_아라고네스	스페인_축구_국가대표팀	team	전 스페인 U-21 축구 국가대표팀 일원으로, 비야는 2005년 2월 9일,  << _sbj_ >> 의 부름을 받아 에스타디오 델 메디테라네오에서 열린 산마리노 축구 국가대표팀와의 2006년 FIFA 월드컵 예선에서 국가대표팀 경기에 처음으로 출전하였고,  << _obj_ >> 이 5-0으로 이겼고, 국가대표팀 1호골은 슬로바키아 축구 국가대표팀와의 2006년 FIFA 월드컵 예선 막판 동점골이었다.
프리드리히_빌헬름_3세	프리드리히_빌헬름_4세	child	 아버지는 프로이센의 왕자인 빌헬름 1세였고, 큰아버지는  << _obj_ >> 였으며, 당시 프로이센의 국왕은  << _sbj_ >> 로 갓 태어난 프리드리히의 할아버지였다.
프리드리히_빌헬름_3세	프리드리히_빌헬름_4세	successor	 아버지는 프로이센의 왕자인 빌헬름 1세였고, 큰아버지는  << _obj_ >> 였으며, 당시 프로이센의 국왕은  << _sbj_ >> 로 갓 태어난 프리드리히의 할아버지였다.
프리드리히_빌헬름_3세	빌헬름_1세	child	 아버지는 프로이센의 왕자인  << _obj_ >> 였고, 큰아버지는 프리드리히 빌헬름 4세였으며, 당시 프로이센의 국왕은  << _sbj_ >> 로 갓 태어난 프리드리히의 할아버지였다.
탈린_대학	에스토니아	country	1950년 이후  << _obj_ >> 에서 살았고, 그녀는 1973년에  << _sbj_ >> 의 교육 학과를 졸업했다.
케일러_나바스	코스타리카_축구_국가대표팀	team	  << _obj_ >> 에서도 활약하고 있으며 현재  << _sbj_ >> 에 이어 2순위 골키퍼로 활약하고 있다.
필바라	오스트레일리아	country	  << _obj_ >>  웨스턴오스트레일리아 주의  << _sbj_ >> 와 애쉬버튼, 머치슨 지역에서 주로 발견된다.
구르마_현	부르키나파소	country	파다응구르마는  << _obj_ >>  동부에 위치한 도시로 동부 주 의 주도이자  << _sbj_ >> 의 현도이며 높이는 294m, 인구는 51,421명이다.
타하르_주	아프가니스탄	country	탈로칸은  << _sbj_ >> 의 주도로,  << _obj_ >>  북동부에 위치하고 있다.
피에트로_모체니고	안드레아_벤드라민	successor	1473년 도제 선출에서 마르첼로는 미래의 도제들인  << _sbj_ >> ,  << _obj_ >> 을 제치고 승리했다.
나이앤틱_(기업)	미국	country	존 행키는  << _obj_ >> 의 기업가로, 포켓몬 고와 인그레스의 제작사로 유명한 모바일 응용 소프트웨어 기업  << _sbj_ >> 의 창업자이다.
마이멘싱	방글라데시	country	마이멘싱 구는  << _obj_ >>  북부에 위치한 구로 행정 중심지는  << _sbj_ >> 이며 면적은 10,485㎢, 인구는 11,370,000명이다.
슬로님	벨라루스	country	치한은  << _obj_ >>  흐로드나주  << _sbj_ >>  지구 흘라시에비치의 한 마을에서 태어났다.
로이틀링겐	독일	country	슈프로이어호프 거리는  << _obj_ >>  바덴뷔르템베르크 주  << _sbj_ >> 에 있는 거리로 세계에서 가장 좁은 거리이다.
AFC_챔피언스리그_2007	성남_FC	team	 2007년 3월 팀과 3년 재계약에 합의하였고, 4월 11일  << _sbj_ >>   << _obj_ >> 와의 경기에서 첫 골을 기록하였다.
노노우티	키리바시	country	데이비드 카토아타우는 1984년 7월 17일  << _obj_ >>   << _sbj_ >> 에서 태어났다.
오렌지워크_구	벨리즈	country	오렌지워크는  << _obj_ >> 에서 4번째로 큰 도시로  << _sbj_ >> 의 행정 중심지이며 인구는 13,708명이다.
007_살인번호	숀_코너리	starring	  << _obj_ >> 가 주연한 초창기의 제임스 본드 영화 시리즈 《 << _sbj_ >> 》, 《007 위기일발》, 《썬더볼 작전》 등을 연출하였다.
비야에르모사	멕시코	country	타바스코 주는  << _obj_ >>  남동부에 위치한 주로 주도는  << _sbj_ >> 이며 면적은 24,731㎢, 인구는 2,309,369명, 인구 밀도는 93명/㎢이다.
에리히_하르트만	루프트바페	country	  << _obj_ >>  동료  << _sbj_ >> 에 이어 역사상 적기 격추수 2위이다.
테픽	멕시코	country	나야리트 주는  << _obj_ >>  서부에 위치한 주로 주도는  << _sbj_ >> 이며 면적은 27,857㎢, 인구는 1,118,468명, 인구 밀도는 40명/㎢이다.
페르_에빈드_스빈후부드	유호_쿠스티_파시키비	successor	 오스카리 토코이,  << _sbj_ >> ,  << _obj_ >>  등이 이끄는 핀란드 원로원에서 농무대신을 역임했다.
그리즐리_맨	베르너_헤어초크	director	 트레드웰의 곰에 대한 관심과 죽음에 관한 내용들은  << _obj_ >> 에 의해 2005년에 다큐멘터리 영화 《 << _sbj_ >> 》으로 제작되었다.
구사우	나이지리아	country	잠파라 주는  << _obj_ >> 의 서북부에 있는 나이지리아의 행정 구역로, 주도는  << _sbj_ >> 이다.
까치_며느리	하희라	starring	출연진에 속했던 김영애  김용건은 담당 PD 염현섭씨의 대학 후배인  << _obj_ >> 가 주인공이었던 MBC  << _sbj_ >> 에서 공연한 바 있었다.
아바칼리키	나이지리아	country	에보니 주는  << _obj_ >> 의 남부에 있는 나이지리아의 행정 구역로, 주도는  << _sbj_ >> 이다.
예나고아	나이지리아	country	바이엘사 주는  << _obj_ >> 의 남부에 있는 나이지리아의 행정 구역로, 주도는  << _sbj_ >> 이다.
석양의_무법자	리_밴클리프	starring	《 << _sbj_ >> 》: 세르조 레오네 감독, 클린트 이스트우드/ << _obj_ >> /일라이 왈릭 주연, 엔니오 모리코네 음악
김진현_(축구_선수)	대한민국_축구_국가대표팀	team	 현재  << _obj_ >>  골키퍼  << _sbj_ >> 의 소속팀이다.
노정윤	산프레체_히로시마	team	 가시와 레이솔에서 뛸 때는 같은 팀의 홍명보가 달았던 20번을,  << _obj_ >> 로 이적하였을때는 같은 팀의  << _sbj_ >> 이 달았던 9번을 달아 화제가 되었다.
케빈_오리스	전북_현대_모터스	team	 4월 13일  << _obj_ >>  원정 경기에서 역시 교체투입되었는데, 후반전 추가 시간  << _sbj_ >> 이 떨구어준 헤딩을 받아 왼발로 천금같은 동점골을 골문 상단으로 꽂아넣었다.
남과_여_(1966년_영화)	클로드_를루슈	director	《 << _sbj_ >> 》는  << _obj_ >>  감독의 영화이다.
얼스터_연합주의자당	북아일랜드	country	 이후 같은해 치뤄진 1974년 10월 영국 총선에서 그는  << _obj_ >> 에서 활동하는  << _sbj_ >> 에 입당해 다운 주 선거구에 출마해 당선된다.
퓨리티	대한민국	country	2012년부터 2014년까지 일본에서  << _sbj_ >> 의 멤버로 활동하였으나,  << _obj_ >> 에서는 데뷔도 못한 채, 2년 만에 팀이 해체되었다.
레슬리_맨	모드_애퍼타우	child	 영화 감독 저드 애퍼타우와  << _sbj_ >> 의 딸이며,  << _obj_ >> 의 동생이다.
몬트멜로	스페인	country	바르셀로나 카탈루냐 서킷은  << _obj_ >>  카탈루냐 지방 바르셀로나 주 북부  << _sbj_ >> 에 있는 서킷이다.
스텔렌보스	남아프리카_공화국	country	그의 육상 경력은 1996년 3월 23일  << _obj_ >>   << _sbj_ >> 에서 열린 세계 크로스컨트리 선수권 대회에서 14위를 할 때 시작되었다.
프레데리크_5세	크리스티안_7세	child	13.  << _obj_ >> ,  << _sbj_ >> 의 아들
프레데리크_5세	크리스티안_7세	child	14. 프레데리크 6세,  << _obj_ >> 의 아들, 왕비 헤센카셀의 마리아는  << _sbj_ >> 의 외손녀
프레데리크_5세	크리스티안_7세	child	15. 크리스티안 8세,  << _sbj_ >> 의 손자, 섭정공 프레데리크의 아들,  << _obj_ >> 의 조카
프레데리크_5세	크리스티안_7세	successor	13.  << _obj_ >> ,  << _sbj_ >> 의 아들
프레데리크_5세	크리스티안_7세	successor	14. 프레데리크 6세,  << _obj_ >> 의 아들, 왕비 헤센카셀의 마리아는  << _sbj_ >> 의 외손녀
프레데리크_5세	크리스티안_7세	successor	15. 크리스티안 8세,  << _sbj_ >> 의 손자, 섭정공 프레데리크의 아들,  << _obj_ >> 의 조카
김준태_(야구_선수)	롯데_자이언츠	team	2016 시즌  << _obj_ >>  주장이 되었고, 8월 무릎을 당해서 남은 경기의 포수 자리는  << _sbj_ >> 와 김사훈이 맡았다.
달비크	아이슬란드	country	  << _obj_ >>  에이야표르수르에 있는  << _sbj_ >> 라는 이름의 어촌 마을의 이름을 따왔다.
카페_소사이어티_(영화)	우디_앨런	director	 개막작으로는 미국의 영화 감독  << _obj_ >> 의 《 << _sbj_ >> 》가 선정되었다.
해럴드_1세	하르다크누트	successor	 중요 인물로는 크누트 대왕 외에 대왕의 아버지 스베인 튜구스케그, 할아버지 하랄드 블라톤, 대왕의 아들인  << _obj_ >> ,  << _sbj_ >> , 스베인 크누트손 등이 있다.
부리람	타이	country	뉴아이모바일 스타디움은  << _obj_ >>   << _sbj_ >> 에 위치한 축구전용경기장이다.
아이패드_에어_2	아이패드_프로	successor	 사용자들은 애플 페이를 통해 아이폰 6, 6 플러스 이상, 애플 워치 호환 기기 ,  << _sbj_ >> ,  << _obj_ >> , 아이패드 미니 3 이상에서 결제가 가능하다.
박세웅_(1995년)	롯데_자이언츠	team	 그의 형은  << _obj_ >> 의  << _sbj_ >> 이다.
300_(영화)	잭_스나이더	director	 《 << _sbj_ >> 》을 시작으로 《왓치맨 》, 《써커 펀치》, 《》 등  << _obj_ >>  감독과 협업하였다.
이스탄불_주	터키	country	베이욜루는  << _obj_ >>   << _sbj_ >> 의 한 구이다.
올_더_프리티_호시즈	빌리_밥_손턴	director	2000년에  << _obj_ >>  감독에 의해 영화화되어 《 << _sbj_ >> 》라는 이름으로 공개되었으며, 맷 데이먼과 페넬로페 크루스가 출연하였다.
업_(영화)	피트_닥터	director	 《인크레더블》, 《카 》, 《라따뚜이 》, 《 << _sbj_ >> 》에서 스토리보드 작업에 참여했고, 《인사이드 아웃》에서  << _obj_ >> , 멕 러포브와 공동 감독을 맡는다.
라이드_어롱	팀_스토리	director	  << _obj_ >> 가 감독, 필 헤이와 맷 맨프레디가 각본을 맡은 작품으로, 2014년 영화 《 << _sbj_ >> 》의 속편이다.
김종규_(농구_선수)	창원_LG_세이커스	team	이번 드래프트에서 가장 주목 받았던  << _sbj_ >> 가 전체 1순위로  << _obj_ >> 의 지명을 받게 되었다.
브라간사_(파라_주)	브라질	country	브라간치누 클루비 두 파라, 또는 브라간치누는  << _obj_ >> 의 축구단으로 파라 주 의  << _sbj_ >> 를 연고로 한다.
프로젝트_A	홍금보	starring	 배우 브루스 리, 성룡,  << _obj_ >> , 원표 등을 거느렸으며, 그동안  << _sbj_ >> , 폴리스 스토리, 홍번구 등 600여 편의 액션 영화를 제작하여 1970-1980년대 홍콩 영화계를 상징한 영화사였다.
프로젝트_A	홍금보	director	 배우 브루스 리, 성룡,  << _obj_ >> , 원표 등을 거느렸으며, 그동안  << _sbj_ >> , 폴리스 스토리, 홍번구 등 600여 편의 액션 영화를 제작하여 1970-1980년대 홍콩 영화계를 상징한 영화사였다.
프로젝트_A	성룡	starring	 배우 브루스 리,  << _obj_ >> , 홍금보, 원표 등을 거느렸으며, 그동안  << _sbj_ >> , 폴리스 스토리, 홍번구 등 600여 편의 액션 영화를 제작하여 1970-1980년대 홍콩 영화계를 상징한 영화사였다.
프로젝트_A	성룡	director	 배우 브루스 리,  << _obj_ >> , 홍금보, 원표 등을 거느렸으며, 그동안  << _sbj_ >> , 폴리스 스토리, 홍번구 등 600여 편의 액션 영화를 제작하여 1970-1980년대 홍콩 영화계를 상징한 영화사였다.
AFC_챔피언스리그_2007	세파한_FC	team	2007년 J1리그에서 가시마 앤틀러스가 우승하여 본래대로라면 개최국 자격으로 참가하여 뉴질랜드의 와이타케레 유나이티드와 플레이오프에서 대결할 예정이었으나,  << _sbj_ >> 에서 우라와 레드 다이아몬즈가 우승함에 따라 개최국 팀의 중복 참가 불허 규정이 적용되어 AFC 챔피언스리그 2007 준우승팀인 이란의  << _obj_ >> 이 대타로 참가하게 되었다.
왕조의_세월	김재형	director	1990년 8월 16일부터 8월 17일까지 한국방송공사에서 신봉승이 각본을 맡고,  << _obj_ >> 이 연출한 광복절 특집드라마 《 << _sbj_ >> 》이 방영되어 이은과 이방자의 일대기를 다루었다.
칼라일_(펜실베이니아_주)	미국	country	미국 육군참모대학교는 1901년  << _obj_ >>  펜실베이니아 주  << _sbj_ >> 에 첫 개교되어 현재에 이르고 있는 미국 국립 육군군사참모대학교이다.
장성우	Kt_위즈	team	그러나 2015년 10월 8일,  << _obj_ >> 의 포수  << _sbj_ >> 가 선수, 리포터 등등 야구장에서 일하는 사람들에 관한 욕설과 성희롱이 담긴 대화내용을 장성우의 전 여자친구 A씨가 SNS에 유포하였고 박기량의 실명이 거론되면서 박기량은 이 둘을 명예훼손으로 고소했다.
주토피아	리치_무어	director	 바이런 하워드,  << _obj_ >> 와 같이 월트 디즈니 애니메이션 스튜디오의 영화 《 << _sbj_ >> 》를 연출하고 각본을 썼다.
급진좌파연합	그리스	country	민중연합당은 '99% 민중의 연합 정당' 임을 강조하면서,  << _obj_ >> 의 집권당  << _sbj_ >>   의 형태를 따라, 내부 정파 형태의 하위 정당들을 갖추고 있다.
멍크턴	캐나다	country	멍크턴 호크스는  << _obj_ >>  뉴브런즈윅 주  << _sbj_ >> 을 연고지로 하는 1987년부터 1994년까지 아메리칸 하키 리그 소속되었던 아이스 하키팀이다.
해피_피트	조지_밀러	director	 《꼬마 돼지 베이브 2》, 《 << _sbj_ >> 》. 《》 등  << _obj_ >>  감독과 협업하고 있다.
종점_(1981년_영화)	정인엽	director	《 << _sbj_ >> 》은 1981년에 개봉한  << _obj_ >>  감독의 영화 작품이다.
남기일	광주_FC	team	 2015 시즌 종료 후 팀을 떠나 무앙통 유나이티드 FC에서 입단 테스트를 보고 있던 2016년 1월, 태국 방콕 전지훈련 중이던  << _obj_ >> 와의 연습 경기에 출전하였고, 이 경기에서  << _sbj_ >>  감독의 눈에 들어 광주로 이적하였다.
김동철_(축구_선수)	서울_이랜드_FC	team	첫번째 시즌에서 승격에 실패한  << _obj_ >> 는 1월 초 전남 드래곤즈 센터백  << _sbj_ >> 과 고양 자이크로 FC 미드필더 김준태 를 영입하며 보강을 시작했다.
김봉래	서울_이랜드_FC	team	이적시장 막바지에 풀백자원이 여전히 부족했던  << _obj_ >> 는 미드필더 김재성 를 제주 유나이티드 FC의  << _sbj_ >> 와 맞임대 트레이드를 하기로 결정했다.
미스터_터너	티머시_스폴	starring	남자배우상 -  << _obj_ >>  《 << _sbj_ >> 》
소셜_네트워크_(영화)	데이비드_핀처	director	《 << _sbj_ >> 》 -  << _obj_ >>  감독의 영화로 페이스북의 설립 실화를 바탕으로 제작된 영화
미나미산리쿠_정	일본	country	리쿠젠미나토 역은  << _obj_ >>  미야기 현 모토요시 군  << _sbj_ >> 에 위치한 동일본 여객철도 게센누마 선의 철도역이다.
사랑은_노래를_타고	이덕건	director	박민규 역의 김명수 , 담당 PD 어수선씨는 1994년 KBS 1TV 토요 단막극 인간극장  6화 '마이더스의 손'에서 연기자-조연출자로 호흡을 맞췄는데 이 드라마의 담당 PD  << _obj_ >> 씨는 <내 마음의 꽃비>에서 그랬던 것처럼 본인의 연출작인  << _sbj_ >> , 별난 며느리에서 아이돌 가수를 캐스팅한 바 있었다.
제록스	미국	country	후지 제록스은 1962년에 일본의 후지필름과  << _obj_ >> 의  << _sbj_ >> 와 합작 설립한 다국적 기업이다.
2015년_수원_JS컵	대한민국_U-20_축구_국가대표팀	team	2015년 4월 29일에 개막한  << _sbj_ >> 에  << _obj_ >>  대표팀 소속으로 출전하였다.
캐나디안_풋볼_리그	에드먼턴_에스키모스	team	  << _sbj_ >>   << _obj_ >> 가 홈 경기장으로 사용하고 있다.
카라소_주	니카라과	country	디리암바는  << _obj_ >>   << _sbj_ >> 의 도시로 면적은 349㎢, 높이는 532m, 인구는 57,542명이다.
러브랜드_(콜로라도_주)	미국	country	콜로라도 이글스는  << _obj_ >>  콜로라도 주  << _sbj_ >> 를 연고지로 하는 ECHL의 서부 콘퍼런스 마운틴 디비전 소속 아이스 하키팀이면, 2003년부터 2011년까지 센트럴 하키 리그에 참가하였다가, 2011~2012시즌부터 ECHL로 옮겼다.
발디비아_현	칠레	country	코랄는  << _obj_ >>  로스리오스 주   << _sbj_ >> 의 코무나이다.
멜리피야_현	칠레	country	알루에는  << _obj_ >>  산티아고 수도주  << _sbj_ >> 의 코무나이다.
엘로아_현	칠레	country	오야궤는  << _obj_ >>  안토파가스타 주  << _sbj_ >> 의 코무나이다.
케빈_데이비스	사우샘프턴_FC	team	 공동 수상은 다섯 번이 있었는데 1994년 11월 블랙번 로버스 FC의 앨런 시어러와 크리스 서튼, 1996년 1월 리버풀의 로비 파울러와 스탄 콜리모어, 1997년 11월  << _obj_ >> 의  << _sbj_ >> 와 맨체스터 유나이티드의 앤드루 콜, 2004년 2월 아스널 FC의 데니스 베르캄프와 에두 가스퍼, 2007년 4월 토트넘 홋스퍼의 디미타르 베르바토프와 로비 킨이다.
인페르노_(2016년_영화)	톰_행크스	starring	 영화로 제작된 천사와 악마, 다빈치 코드와  << _sbj_ >> 에서는  << _obj_ >> 가 역할을 맡아 출연했다.
뉘른베르크의_전투	포르투갈_축구_국가대표팀	team	 이 대회에 참가한 선수들은 총 345장의 옐로카드와 28장의 레드카드를 받는 신기록을 세웠고,  << _sbj_ >> 로 알려진  << _obj_ >> 과 네덜란드 축구 국가대표팀 간의 16강 경기를 주관한 러시아인 발렌틴 발렌티노비치 이바노프 주심은 이 경기에서 16장의 옐로카드와 4장의 레드카드를 꺼냈다.
바실리_베레주츠키	PFC_CSKA_모스크바	team	 그의 쌍둥이 형제인  << _sbj_ >>  역시  << _obj_ >> 에서 활약하고 있다.
윤승선	대한민국_해군	country	그의 이복 형  << _sbj_ >> 도 6.25 전쟁 참전 용사로  << _obj_ >> 과 대한민국 해병대의 창립에 참여하였으며, 해군본부 시설감, 해병대 공병감을 역임했다.
온도_주	나이지리아	country	아쿠레는  << _obj_ >>  남서부에 위치한  << _sbj_ >> 의 주도로 인구는 941,410명이다.
이주인_고로	일본_제국_해군	country	이주인 신관은  << _obj_ >> 의  << _sbj_ >>  대좌가 고안한 신관으로, 1900년에 채택되었다.
스비슈토프	불가리아	country	 강 반대쪽에는  << _obj_ >>   << _sbj_ >> 가 위치한다.
더_투나잇_쇼	지미_팰런	starring	  << _obj_ >> 이 진행하는  << _sbj_ >> 에서 텔레비전 데뷔를 했다.
메데아_주	알제리	country	메데아는  << _obj_ >> 의 도시로  << _sbj_ >> 의 주도이며 면적은 63.5㎢, 높이는 1,036m, 인구는 145,441명, 인구 밀도는 2,300명/㎢이다.
보르즈부아레리즈_주	알제리	country	보르즈부아레리즈는  << _obj_ >> 의 도시로  << _sbj_ >> 의 주도이며 면적은 81.10㎢, 높이는 928m, 인구는 158,812명, 인구 밀도는 2,000명/㎢이다.
워런_(미시간_주)	미국	country	빅보이 레스토랑는  << _obj_ >>  미시간 주  << _sbj_ >> 에 있는 햄버거 전문 레스토랑 체인이다.
일본_제국_해군	군령부	country	해군반성회는 1980년부터 1991년까지  << _sbj_ >>   << _obj_ >> , 제2복원성 OB가 일반에 공개하지 않고 비밀리에 조직한 해군 퇴역자들의 교육 집단이다.
트루스_어바웃_엠마누엘	카야_스코델라리오	starring	 2015년 제시카 비엘,  << _obj_ >> , 앨프리드 몰리나 주연의 영화 《 << _sbj_ >> 》을 연출했다.
그랜드_피아노_(영화)	일라이저_우드	starring	  << _obj_ >> , 존 큐잭 주연의 영화 《 << _sbj_ >> 》를 연출했다.
한중록_(드라마)	최명길_(배우)	starring	1988년 MBC 드라마 《 << _sbj_ >> 》  << _obj_ >>
대왕의_길	홍리나	starring	1998년 MBC 드라마 《 << _sbj_ >> 》 -  << _obj_ >>
유자_정	일본	country	메가 역은  << _obj_ >>  야마가타 현 아쿠미 군  << _sbj_ >> 에 위치한 동일본 여객철도 우에쓰 본선의 철도역이다.
잔스타트	네덜란드	country	잔담은  << _obj_ >>  노르트홀란트 주  << _sbj_ >> 에 위치한 지방 자치체로 인구는 72,597명이다.
로제르_주	프랑스	country	망드는  << _obj_ >>  남부 랑그도크루시용  << _sbj_ >> 에 위치한 도시로 로제르 주의 주도이며 면적은 36.56㎢, 인구는 12,378명, 인구 밀도는 340명/㎢이다.
시파키라	콜롬비아	country	포르탈레사 FC는  << _obj_ >> 에 위치한  << _sbj_ >> 를 연고로 하는 축구팀이다.
이게로테	베네수엘라	country	브리온 시는  << _obj_ >>  미란다 주의 지방 자치체로 행정 중심지는  << _sbj_ >> 이며 면적은 531㎢, 인구는 56,699명이다.
카우카과	베네수엘라	country	아세베도 시는  << _obj_ >>  미란다 주의 지방 자치체로 행정 중심지는  << _sbj_ >> 이며 면적은 1,879㎢, 인구는 88,289명이다.
2012년_FIFA_U-20_여자_월드컵	대한민국_U-20_여자_축구_국가대표팀	team	2012년부로  << _obj_ >>  감독도 병행하기 시작했고,  << _sbj_ >> 과 2014년 FIFA U-20 여자 월드컵 8강 진출을 이끌어냈다.
2015년_미얀마_총선거	미얀마	country	 이 정당은 얼마전까지만 해도  << _obj_ >> 의 최대 야당이었으나, 2015년 11월 13일  << _sbj_ >> 에서 집권하여 여당이 되어 정권교체를 하게 되었다.
디나가트_섬	필리핀	country	수리가오 해협은  << _obj_ >>  레이테 섬, 파나안 섬과 민다나오,  << _sbj_ >>  사이의 해협으로 북쪽의 레이테 만과 남쪽의 민다나오 해를 잇는다.
솔리헐	영국	country	 1981년에  << _obj_ >>   << _sbj_ >>  공장이 현대화됨에 따라 4도어가 출시되었으며, 1984년에는 기존 판매되던 2도어가 단종되었다.
민족_볼셰비키당	러시아	country	다른 러시아는  << _sbj_ >> 을 계승하는 에두아르드 리모노프가 당수인  << _obj_ >> 의 민족 볼셰비즘 정당이다.
아맘바이_주	파라과이	country	페드로후안카바예로는  << _obj_ >> 의 도시로  << _sbj_ >> 의 주도이며 면적은 588㎢, 높이는 607m, 인구는 75,109명이다.
산티아고델에스테로_주	아르헨티나	country	테르마스데리오온도는  << _obj_ >>   << _sbj_ >> 에 위치한 도시로 높이는 265m, 인구는 27,838명이다.
수루츠	터키	country	2015년 수루츠 폭탄 테러는 2015년 7월 20일  << _obj_ >>  샨리우르파 주  << _sbj_ >>  아마라 문화 센터 외부에서 발생한 폭탄 테러이다.
오레야나_주	에콰도르	country	푸에르토프란시스코데오레야나는  << _obj_ >>  동부에 위치한 도시로  << _sbj_ >> 의 주도이며 면적은 146.26㎢, 높이는 300m, 인구는 45,163명이다.
2005_UEFA_챔피언스리그_결승전	리버풀_FC	team	 카카는 그 시즌 밀란의 UEFA 챔피언스리그 2004-05에서 중추적인 역할을 맡아  << _obj_ >> 과의  << _sbj_ >> 에 오를 수 있게 도왔는데, 이 과정에서 2골을 기록하고 5골을 도왔다.
블랙_호크_다운_(영화)	리들리_스콧	director	  << _obj_ >>  감독이 《 << _sbj_ >> 》으로 영화화했다.
엔드_오브_왓치	데이비드_에이어	director	 2012년 《 << _sbj_ >> 》를 시작으로,  << _obj_ >>  감독과 협업해왔다.
아메리카_농구_협회	볼티모어_불리츠	team	 과거  << _sbj_ >> /전미 농구 협회  << _obj_ >> 의 홈경기장으로 사용했다.
과테말라_주	과테말라	country	아마티틀란은  << _obj_ >>   << _sbj_ >> 의 도시로 면적은 204㎢, 높이는 1,188m, 인구는 82,870명이다.
바하베라파스_주	과테말라	country	살라마는  << _obj_ >> 의 도시로  << _sbj_ >> 의 주도이며 면적은 776㎢, 높이는 940m, 인구는 56,359명이다.
우술루탄_주	엘살바도르	country	우술루탄은  << _obj_ >> 의 도시로  << _sbj_ >> 의 주도이며 면적은 139.75㎢, 높이는 90m, 인구는 73,064명, 인구 밀도는 520명/㎢이다.
아우아차판_주	엘살바도르	country	아우아차판은  << _obj_ >>  서부에 위치한 도시로  << _sbj_ >> 의 주도이며 면적은 244.84㎢, 높이는 799m, 인구는 110,511명, 인구 밀도는 450명/㎢이다.
진순진	대한민국_축구_국가대표팀	team	중앙대학교 재학 중이던 1998년  << _sbj_ >> 과 함께  << _obj_ >>  훈련에 테스트 선수 자격으로 참가하여 10일 간 테스트를 받았으나 발탁되지는 못하였다.
산토도밍고_주	도미니카_공화국	country	산토도밍고에스테는  << _obj_ >> 의 도시로  << _sbj_ >> 의 주도이며 면적은 106.29㎢, 인구는 701,269명, 인구 밀도는 6,600명/㎢이다.
코라손_아키노	피델_라모스	successor	 전임인 글로리아 마카파갈 아로요, 조지프 에스트라다,  << _obj_ >> ,  << _sbj_ >> 도 이 학교 출신이거나 또는 관련이 있다.
산토도밍고데로스차칠라스_주	에콰도르	country	산토도밍고 또는 산토도밍고데로스콜로라도스는  << _obj_ >>   << _sbj_ >> 의 주도로 면적은 1,092.89㎢, 인구는 305,632명, 해발고도는 625m, 인구 밀도는 280명/㎢이다.
신포시	조선민주주의인민공화국	country	륙대동역은  << _obj_ >>  함경남도  << _sbj_ >> 에 위치하고 있는 평라선의 철도역이다.
내셔널_바스켓볼_리그_오브_캐나다	핼리팩스_허리케인즈	team	 과거  << _sbj_ >>  핼리팩스 라인멘와 아메리칸 하키 리그 노바스코샤 보이저스, 노바스코샤 오일러스, 핼리팩스 시타델스의 홈경기장으로 사용했으면, 현재 내셔널 바스켓볼 리그 오브 캐나다  << _obj_ >> 의 홈경기장으로 사용되고 있다.
내셔널_바스켓볼_리그_오브_캐나다	윈저_익스프레이스	team	  << _sbj_ >>   << _obj_ >> 의 홈경기장으로 사용되고 있다.
도밍고_카이세도	호아킨_모스케라	successor	 이들 중 많은 사람들이 이에 찬성했으나, 시몬 볼리바르와  << _sbj_ >> , 그리고  << _obj_ >> 와 같은 대통령직에 있던 이들은 반대했다.
센트럴_하키_리그	오클라호마시티_블레이저스	team	 NBA 게토레이 리그 오클라호마시티 블루의 홈경기장으로 사용되고 있으며, 과거 아메리칸 하키 리그 오클라호마시티 배런스와  << _sbj_ >>   << _obj_ >> 의 홈경기장으로 사용했다.
화이트플레인스_(뉴욕_주)	미국	country	웨스트체스터 카운티 센터는  << _obj_ >>  뉴욕 주  << _sbj_ >> 에 위치한 실내 경기장이다.
랭커스터_(랭커셔_주)	랭커셔_주	country	시티오브랭커스터는 잉글랜드  << _obj_ >> 의 도시로 중심 도시는  << _sbj_ >> 이며 면적은 575.86㎢, 인구는 133,914명이다.
샌브루노	미국	country	샌안드레아스 호는  << _obj_ >>  캘리포니아 주 샌미티어 군에 있는 도시 밀브레와  << _sbj_ >> 에 인접한 저수지이다.
비르_타윌	무주지	country	북수단 왕국은 2014년에 세워진 마이크로네이션으로 이집트와 수단 사이에 위치한  << _obj_ >> 인  << _sbj_ >> 을 영토로 주장하고 있다.
매드_맥스	조지_밀러_(영화_감독)	director	  << _obj_ >> 와 바이런 케네디에 의해 창조되었으며, 《 << _sbj_ >> 》 , 《매드 맥스 2》 , 《매드 맥스 3》 에서는 멜 깁슨이 연기를 하였으며, 《》 에서는 톰 하디가 연기를 하였다.
매드_맥스_3	멜_깁슨	starring	 조지 밀러 와 바이런 케네디에 의해 창조되었으며, 《매드 맥스》 , 《매드 맥스 2》 , 《 << _sbj_ >> 》 에서는  << _obj_ >> 이 연기를 하였으며, 《》 에서는 톰 하디가 연기를 하였다.
안드레아_피를로	유벤투스_FC	team	 그리고 2006년 FIFA 월드컵에서는 같은 해에 터진 세리에 A의 2006년 이탈리아 축구 스캔들이 발각되어 소속팀인  << _obj_ >> 와 이탈리아 축구계가 어두운 분위기에 휩싸이던 중, 젠나로 가투소,  << _sbj_ >> , 다니엘레 데 로시와 활약해 이탈리아의 네 번째 FIFA 월드컵에 공헌하였다.
즐라탄_이브라히모비치	FC_인테르나치오날레_밀라노	team	2009년 여름 FC 바르셀로나와 인테르가  << _sbj_ >> 과 에토+40m의 스왑딜에 합의하여, 에토는 5년 계약으로  << _obj_ >> 에 입단하였다.
즐라탄_이브라히모비치	스웨덴_축구_국가대표팀	team	 2004년 8월 18일,  << _obj_ >> 과의 친선전에서, 그는 전 아약스 동료인  << _sbj_ >> 에 부상되었고, 이 사건으로 이브라히모비치는 2주 후에 유벤투스 FC로 매각되었고, 그에 앞서 스웨덴 국가대표가 고의로 판 데르 파르트에게 부상을 입히려 했다는 주장이 제기되었다.
바도비체	폴란드	country	카롤 유제프 보이티와는 1920년 5월 18일  << _obj_ >>  남부의 마을  << _sbj_ >> 에서 3남매 가운데 막내로 태어났다.
알라_웃딘_테키시	알라_웃딘_무함마드	child	테르켄 카툰은 호라즘 제국의 태후로  << _sbj_ >> 의 부인이며  << _obj_ >> 의 어머니이다.
알라_웃딘_테키시	알라_웃딘_무함마드	successor	테르켄 카툰은 호라즘 제국의 태후로  << _sbj_ >> 의 부인이며  << _obj_ >> 의 어머니이다.
뉴암스테르담_(가이아나)	가이아나	country	이스트버비스코렌타인 주는  << _obj_ >>  동부에 있는 주로 주도는  << _sbj_ >> 이며 면적은 36,234㎢, 인구는 109,431명, 인구 밀도는 3.0명/㎢이다.
테나	에콰도르	country	나포 주는  << _obj_ >>  중부에 위치한 주로 주도는  << _sbj_ >> 이며 면적은 12,542.50㎢, 인구는 103,697명, 인구 밀도는 8.3명/㎢이다.
세로데파스코	페루	country	파스코 주는  << _obj_ >>  중부에 위치한 주로 주도는  << _sbj_ >> 이며 면적은 25,319.59㎢, 인구는 277,475명이다.
앙골	칠레	country	마예코 현은  << _obj_ >>  아라우카니아 주를 구성하는 2개의 현 가운데 하나로 현도는  << _sbj_ >> 이며 면적은 13,433.3㎢, 인구는 196,190명, 인구 밀도는 15명/㎢이다.
카우케네스	칠레	country	카우케네스 현은  << _obj_ >>  마울레 주를 구성하는 4개의 현 가운데 하나로 현도는  << _sbj_ >> 이며 면적은 3,027.2㎢, 인구는 54,145명, 인구 밀도는 18명/㎢이다.
만프레디	카를로_1세	successor	 구엘프 파를 지원했던 탓에 시에나에게 탄압받던 그들은  << _sbj_ >> 가 있을 당시 시에나를 떠나, 카페 앙주 가문이 승리를 거둔 후에 돌아왔고, 콘라딘이 짧은 통치 기간에 한 차례 더 추방당하였으며,  << _obj_ >> 의 도움으로 다시 돌아왔다.
몬테플라타	도미니카_공화국	country	몬테플라타 주는  << _obj_ >>  동부에 위치한 주로 주도는  << _sbj_ >> 이며 면적은 2,632.14㎢, 인구는 222,641명이다.
엘세이보	도미니카_공화국	country	엘세이보 주는  << _obj_ >>  동부에 위치한 주로 주도는  << _sbj_ >> 이며 면적은 1,786.80㎢, 인구는 110,212명이다.
알레산드로_네스타	AC_밀란	team	라치오는 시니샤 미하일로비치와  << _sbj_ >> , 마르셀로 살라스 그리고 파벨 네드베드 같은 선수들과 1995년에 준우승, 1996년에 3위, 1997년에 4위, 1999년에는 리그 마지막 날에 1점 차이로  << _obj_ >> 에게 우승을 놓치고, 마침내 스벤예란 에릭손 감독과 함께 2000년에 두 번째 스쿠테토와 코파 이탈리아를 우승하며 인상적이고 드문 더블을 했다.
클라우디오_마르키시오	유벤투스_FC	team	유럽 클럽 대항전 출전이 현실로 다가오자, 경영진들은 FC 인테르나치오날레 밀라노의 카를루스 에두아르두 지 카스트루 로렌수, AC 밀란의 이냐치오 아바테와 리노 마르초라티,  << _obj_ >> 의 세바스티안 조빈코,  << _sbj_ >> , 레이 볼파토 같은 세리에 A의 빅클럽들의 유망주 몇명을 공동 소유 계약으로 데려와 선수단을 강화시켰다.
세바스티안_조빈코	유벤투스_FC	team	유럽 클럽 대항전 출전이 현실로 다가오자, 경영진들은 FC 인테르나치오날레 밀라노의 카를루스 에두아르두 지 카스트루 로렌수, AC 밀란의 이냐치오 아바테와 리노 마르초라티,  << _obj_ >> 의  << _sbj_ >> , 클라우디오 마르키시오, 레이 볼파토 같은 세리에 A의 빅클럽들의 유망주 몇명을 공동 소유 계약으로 데려와 선수단을 강화시켰다.
프란체스코_그라치아니	토리노_FC	team	 그는 재빨리 팀의 노래와 로고를 바꿔 일부팬들의 불만이 생겨났지만, 그는  << _obj_ >> 에서  << _sbj_ >> , 에랄도 페치를, 세비야 FC에서 다니엘 베르토니를, AC 몬차 브리안차 1912에서 다니엘로 마사로를, UC 삼프도리아에서 젊은 피에트로 비에르코보드 같은 뛰어난 선수들을 데려오기 시작하였다.
후이_코스타	SL_벤피카	team	 세리에 A로 돌아온후,  << _obj_ >> 에서 유망주  << _sbj_ >> 와 새로운 세계 챔피언 브라질 대표팀의 수비수 마르시우 호베르투 두스 산투스를 영입하며 라니에리는 새로운 팀의 득점원 바티스투타를 중심으로 훌륭한 팀을 만들었다.
루카_토니	엘라스_베로나_FC	team	  << _sbj_ >>  역시도 새로운 세리에 A 승격팀인  << _obj_ >> 로 떠났다.
하리스_세페로비치	레알_소시에다드	team	  << _sbj_ >> 는 라 리가 팀  << _obj_ >> 로 이적시켰다.
마니시	포르투갈_축구_국가대표팀	team	2006년, 아틀레티코는  << _obj_ >> 의 미드필더 코스티냐와  << _sbj_ >> 와 함께 아르헨티나 축구 국가대표팀 공격수 세르히오 아구에로를 영입하였다.
호세_안토니오_레예스	아스널_FC	team	 그 외로 SL 벤피카에서 포르투갈 윙어인 시망 사브로자을,  << _obj_ >> 에서 윙어  << _sbj_ >> 를 €12M에 영입하였다.
UEFA_챔피언스리그_2002-03	유벤투스_FC	team	 밀란에서의 첫 시즌에  << _obj_ >> 를 꺾고  << _sbj_ >>  우승을 하였고, 개인통산 세 번째 코파 이탈리아 우승컵을 들어올렸다.
코로넬오비에도	파라과이	country	카과수 주는  << _obj_ >>  남동부에 위치한 주로 주도는  << _sbj_ >> 이며 면적은 11,474㎢, 인구는 448,983명, 인구 밀도는 39명/㎢이다.
산비센테_(엘살바도르)	엘살바도르	country	산비센테 주는  << _obj_ >>  중부에 위치한 주로 주도는  << _sbj_ >> 이며 면적은 1,184㎢, 인구는 174,561명이다.
올나이트닛폰	일본	country	 1975년에는  << _obj_ >> 의 방송 채널인 닛폰 방송의 심야 라디오 프로그램인  << _sbj_ >> 의 진행자를 맡기도 했는데, 이는 일본 황실으로서는 유일무이한 경력이었다.
마사테낭고	과테말라	country	수치테페케스 주는  << _obj_ >>  남서부에 위치한 주로 주도는  << _sbj_ >> 이며 면적은 2,510㎢, 인구는 403,945명이다.
우에우에테낭고	과테말라	country	우에우에테낭고 주는  << _obj_ >>  북서부에 위치한 주로 주도는  << _sbj_ >> 이며 면적은 7,403㎢, 인구는 846,544명이다.
요로_(온두라스)	온두라스	country	요로 주는  << _obj_ >>  북부에 위치한 주로 주도는  << _sbj_ >> 이며 면적은 7,939㎢, 인구는 503,886명이다.
팍세	라오스	country	팍세 국제공항은  << _obj_ >>   << _sbj_ >> 에 위치한 공항이다.
박건우_(1990년)	두산_베어스	team	1호 비디오판독 :  << _obj_ >>   << _sbj_ >>
북동연방대학교	러시아	country	 한국인 최초로 하버드 대학교에서 언어학 박사 학위 를 취득한 후, 1997년부터 2014년까지 중앙대학교 영어영문학과 교수로, 2014년부터 2016년까지  << _obj_ >>   << _sbj_ >> 에서 근무한 바 있다.
쑨원	쑨진완	child	쑨진위안은 청나라 태생의 중화민국 여자으로  << _sbj_ >>  前 중화민국 중화민국 총통의 장녀이며 쑨커 前 중화민국 고시원의 누이동생이고  << _obj_ >>  여사의 언니이며 쑨메이 前 중화민국 광둥 성 광저우 시 광둥 성 도독의 조카딸이다.
쑨원	쑨진위안	child	쑨진완은 미국 하와이 주에서 출생한 중화민국 여자으로  << _sbj_ >>  前 중화민국 중화민국 총통의 차녀이고 쑨커 前 중화민국 고시원과  << _obj_ >>  여사의 누이동생이며 쑨메이 前 중화민국 광둥 성 광저우 시 광둥 성 도독의 조카딸이다.
클라우디오_브라보	FC_바르셀로나	team	 과르디올라가 맨시티 감독 부임 이후, 지난 시즌까지 수비를 책임진 마르틴 데미첼리스를 RCD 에스파뇰로 이적시킨 후, 보루시아 도르트문트에서 활약한 미드필더 일카이 귄도간을 영입했고, 에버튼 FC에서 활약한 수비수 존 스톤스를 데려왔으며, 2016년 8월 25일에는  << _obj_ >> 에서 활약한 칠레 국가대표 골키퍼  << _sbj_ >> 를 영입하였다.
솔_캠벨	포츠머스_FC	team	 그는 1군에 자리를 잡은 적이 없었는데, 그는  << _sbj_ >> 과 콜로 투레에 밀려  << _obj_ >> 로 한동안 임대되었다.
마누엘_아사냐	프란시스코_프랑코	successor	  << _sbj_ >> 가 이끄는 좌파 인민전선 정부와  << _obj_ >> 를 중심으로 한 우파 반란군 사이에 있었던 내전이다.
AFC_풋살_선수권_대회	이란_풋살_국가대표팀	team	1999년 AFC 풋살 선수권 대회는  << _sbj_ >> 의 첫번째 대회로  << _obj_ >> 이 대한민국 풋살 국가대표팀을 꺽고 우승을 차지했다.
박태수	FC_안양	team	 주축선수들의 공백을 메꾸기 위해  << _obj_ >> 에 영입속도도 빨라질수 밖에 없어서 대전 시티즌에서 계약해지로 풀린 이동현 을 시작으로 충주 험멜 축구단의 센터백 듀오  << _sbj_ >> . 유종현 . 경남 FC에 저돌적인 공격수 안성빈이 FA로 팀에 합류했다.
안동혁_(축구_선수)	천안시청_축구단	team	 광주 FC 창단멤버였던  << _sbj_ >>  역시  << _obj_ >>  에서 자유계약으로 데려와 구색을 맞추고 있는 상태이다.
블루_재스민	샐리_호킨스	starring	 2014년 제19회 엠파이어 시상식 때 엠파이어 남우조연상과 같이 처음으로 수여되었으며, 첫 수상자는 《 << _sbj_ >> 》의  << _obj_ >> 였다.
마르코_아멜리아	AC_밀란	team	2009년 4월 26일, 그는 부상을 입은  << _sbj_ >> 를 대신하여  << _obj_ >>  원정 경기에 투입되었고, 경기가 종료되고 히카르두 카카가 그의 경기 활약상에 대해 축하해주기도 했다.
천생연분_리턴즈	이휘재	starring	 2015년 12년만에 부활이 발표되었고, 지상파가 아닌 케이블 채널 MBC Every 1을 통해 2015년 3월 10일 새로운 시즌인  << _sbj_ >> 가  << _obj_ >> , 이특 의 새로운 MC 체제로 방영된 바 있다.
도루_강	포르투갈	country	 이와 비슷하게,  << _obj_ >> 에서도 비슷한 정책을 펼쳐  << _sbj_ >>  남쪽에서는 절멸하게 되었다.
로프_(영화)	앨프리드_히치콕	director	 1929년 패트릭 해밀턴의 연극 《로프》, 1948년  << _obj_ >> 의 영화 《 << _sbj_ >> 》, 1959년 리처드 플라이셔의 영화 《컴펄전》, 1992년 톰 칼린의 《스운》, 2003년 스티븐 돌기노프의 뮤지컬 《쓰릴 미》 등이 있다.
앵커맨_(영화)	윌_페럴	starring	 배우  << _obj_ >> 과 협업하여 《 << _sbj_ >> 》, 《디 아더 가이스》 등의 영화를 연출했다.
벤자민_스탐불리	몽펠리에_HSC	team	 이후 비야레알 CF의 중앙 수비수 마테오 무사키오를 영입하려 했으나 비야레알의 강력한 반대로 대신 세비야 FC의 유로파 리그 우승을 이끈 페데리코 파시오를 영입했고, 포체티노 감독의 전 팀 사우샘프턴에서 중용하던 미드필더 모르간 슈네데를랭과 스트라이커 제이 로드리게스의 영입을 성사했으나 사우샘프턴 팬들의 반발로 무산되어  << _obj_ >> 의 수비형 미드필더  << _sbj_ >> 를 막판에 영입했다.
시모네_차차	US_사수올로_칼초	team	 겨울 이적시장에서는 페예노르트의 장 폴 뵈티우스, 에버튼 FC의 케빈 미라야스,  << _obj_ >> 의  << _sbj_ >>  등 무성했던 루머에 비해 노튼의 스완지 이적, 레넌의 에버튼 임대, 종료 직전 MK 돈스 FC의 유망주인 데일 앨리를 영입한 후 재임대를 보낸 것으로 초라하게 마쳤다.
카스피_해	투르크메니스탄	country	마사게타이 는 고대 이란인들의 유목연맹체로,  << _sbj_ >>  동부 중앙아시아의 스텝 지대, 즉 오늘날의  << _obj_ >> , 아프가니스탄, 서부 우즈베키스탄, 남부 카자흐스탄을 점유했다.
호를리우카	도네츠크_주	country	호를리우카 전투는 2014년 7월 20일 우크라이나군이 도네츠크 인민 공화국이 장악한  << _obj_ >> 의  << _sbj_ >> 를 탈환하려고 진격하면서 시작된 전투이다.
플래닛_테러	로버트_로드리게스	director	《데쓰 프루프》는 "그라인드하우스"에서 엑스플로이테이션 영화들을 더블 픽쳐 상영을 하는 경험을 보여주기 위해, 《그라인드 하우스》라는 공동 제목하에  << _obj_ >> 의 《 << _sbj_ >> 》와 함께 더블 픽쳐의 일부분으로서 미국에서 개봉되었다.
디_인터뷰	세스_로건	starring	 죽마고우인  << _obj_ >> 과의 협작 영화들로 잘 알려져 있으며, 대표작으로 《슈퍼배드 》, 《파인애플 익스프레스》, 《디스 이즈 디 엔드》, 《 << _sbj_ >> 》가 있다.
디_인터뷰	세스_로건	director	 죽마고우인  << _obj_ >> 과의 협작 영화들로 잘 알려져 있으며, 대표작으로 《슈퍼배드 》, 《파인애플 익스프레스》, 《디스 이즈 디 엔드》, 《 << _sbj_ >> 》가 있다.
마쓰이_유키	도호쿠_라쿠텐_골든이글스	team	 시즌 초반에는 호조를 이루면서 특히 5월 4일  << _obj_ >> 와의 경기에서는 3안타를 때려내며 맹타를 기록했고 이틀날인 5월 5일 역시 라쿠텐과의 경기에서 9회에  << _sbj_ >> 로부터 홈런을 날리는 등 4안타, 4사구를 포함한 전타석 출루를 기록하였다.
유강남	LG_트윈스	team	3차전 MVP :  << _obj_ >>   << _sbj_ >>  4타수 1안타 2타점 1득점 1홈런 
김정남_(축구인)	한국프로축구연맹	team	 K리그 클래식 울산 현대 축구단의 축구 감독이자 현재  << _obj_ >>  부총재를 맡고 있는  << _sbj_ >> 의 외종질녀이다.
뮤직뱅크	솔빈	starring	《 << _sbj_ >> 》 - 고정 MC  << _obj_ >>  
막사이사이상	필리핀	country	 1962년  << _obj_ >> 에서  << _sbj_ >> 을 수상했다.
다니가키_사다카즈	아베_신조	successor	초점은 포스트 고이즈미의 존재로, 여론조사에서는  << _obj_ >> , 아소 다로,  << _sbj_ >> , 후쿠다 야스오 정도가 물망에 올랐지만, 후쿠다 이외에는 모두가 각료로 기용되었다.
오와니_정	일본	country	오와니 선은  << _obj_ >>  아오모리 현 미나미쓰가루 군  << _sbj_ >> 의 오와니온센 역부터 아오모리 현 히로사키 시의 주오히로사키 역을 잇는 고난 철도의 철도 노선이다.
김성현_(1987년)	SK_와이번스	team	사상 처음으로 시행된 와일드카드전에서는 4위 넥센 히어로즈와 5위  << _obj_ >> 가 만났고, 연장 11회 접전 끝에 넥센 히어로즈가 SK 와이번스의 유격수  << _sbj_ >> 의 끝내기 실책으로 5:4로 승리하면서 1승의 어드밴티지를 얻은 4위 넥센이 한 경기만 치르고 준플레이오프에 진출하게 되었다.
간신	임지연	starring	한편, 캐스팅 문제로 골치를 썩였는데 현빈 이승기 등이 차도현 역 물망에 올랐으나 이런저런 사정으로 고사했고  << _obj_ >> 이 여주인공으로 낙점되었지만 영화  << _sbj_ >>  촬영일과 겹쳐 캐스팅 제의를 뿌리쳤다.
사바라가무와_주	스리랑카	country	라트나푸라는  << _obj_ >>   << _sbj_ >> 의 주도이다.
우파_(도시)	러시아	country	FC 우파는  << _obj_ >>  바시키르 공화국의 수도  << _sbj_ >> 를 연고로 하는 축구 클럽이다.
헤라클리우스	콘스탄티누스_3세	successor	  << _obj_ >> 의 아들로 원래 이름은 "헤라클리우스" 였는데 같은 이름의 할아버지  << _sbj_ >> 와 혼동을 피하기 위하여 콘스탄스로 바꾸었다.
아마데오_1세	알폰소_12세	successor	 전제군주였던 페르난도 7세에 대항하여 발생했던 자유주의적 반란인 스페인 반란이 있었던 1822년부터 1823년까지,  << _sbj_ >> 가 왕으로 즉위했던 1870년부터 스페인 제1공화국이  << _obj_ >> 로 전복된 1874년까지, 마지막으로 알폰소 13세된 1931년부터 스페인 내전으로 인한 스페인 제2공화국이 프란시스코 프랑코에 전복된 1939년까지는 국가였다.
라이스_대학교	미국	country	 서울특별시에서 태어나 경신 고등학교, 건국대학교 음악교육학과를 졸업하고 1982년에  << _obj_ >> 으로 유학해  << _sbj_ >>  석사 와 로체스터 대학교 이스트만 음대에서 지휘과 박사과정을 수료했다.
뮌스터_대학교	독일	country	김수환은 1956년 7월 35세에  << _sbj_ >> 에 진학하였는데 그 시절  << _obj_ >> 에 일하러 온 한국 노동자들을 돌보는 일을 맡아 학업을 지속하는데 어려움을 겪다가 결국 졸업하지 못했다.
아누샤_무함마드	후다이다드_칸	child	아우랑 칸은 칸의 권력을 강화하는 정책을 펼쳤던  << _sbj_ >> 의 자식이며, 형제인  << _obj_ >> 이 사망한 이후 쿠다이쿨로프 이나카의 도움으로 칸의 직위에 올랐다.
아누샤_무함마드	후다이다드_칸	successor	아우랑 칸은 칸의 권력을 강화하는 정책을 펼쳤던  << _sbj_ >> 의 자식이며, 형제인  << _obj_ >> 이 사망한 이후 쿠다이쿨로프 이나카의 도움으로 칸의 직위에 올랐다.
유현_(축구_선수)	강원_FC	team	통산 두 번째 우승을 차지한 내셔널리그 2008이 끝나고 최순호 감독이  << _obj_ >> 의 감독으로 부임하며 울산 현대미포조선을 떠났고, 그와 함께 김영후,  << _sbj_ >>  등의 주축 선수들을 영입해갔다.
프랑크_리베리	올랭피크_드_마르세유	team	 하밋 알튼톱이 FC 샬케 04로부터, 루카 토니가 ACF 피오렌티나로부터, 미로슬라프 클로제가 SV 베르더 브레멘으로부터, 그리고  << _sbj_ >> 가 기록적인 이적료로  << _obj_ >> 로부터 이적하였다.
다구치_소	오릭스_버펄로스	team	1이닝 4탈삼진 : 2000년 9월 3일, 대  << _obj_ >>  23차전, 2회초에 조지 아리아스·고시마 유지·히다카 다케시· << _sbj_ >> 로부터 ※역대 7번째
김민재_(1973년)	롯데_자이언츠	team	 경기는 결국 뒤이은 마해영과 임수혁의 홈런과  << _sbj_ >> 의 결승 안타, 주형광의 마무리 역투에 힘입어  << _obj_ >> 가 6:5로 승리하면서 1999년 한국시리즈에 진출하였고 이 패배로 한국시리즈 진출이 좌절된 당시 삼성 라이온즈 감독 서정환이 사임했다.
곤바데카부스	이란	country	곤바데 카부스는  << _obj_ >>   << _sbj_ >> 에 있는 타워이다.
존_프러퓨모	영국	country	프러퓨모 사건은 1962년 당시  << _obj_ >> 의 해럴드 맥밀런 정권의 정치인  << _sbj_ >> 가 소련 측 스파이와 관계가 있는 매춘부에 국가 기밀을 누설했다고 의심된 사건이다.
장기빈	장발_(화가)	child	 인천광역시 출생이며 일제 강점기 평안남도 중화군과 경성부에서 잠시 유년기를 보낸 적이 있는 그는  << _sbj_ >>  前 부산지방국세청의 막내아들이고 장면 前 대한민국의 국무총리와  << _obj_ >>  前 이탈리아 주재 대한민국 대사의 친아우이기도 하다.
비긴_어게인	애덤_리바인	starring	Lost Stars는 마룬 5의 보컬리스트이자 배우인  << _obj_ >> 의 노래로, 본래 뮤지컬 로맨틱 코메디 영화 《 << _sbj_ >> 》의 배경음악이다.
람보르기니_무르시엘라고	람보르기니_아벤타도르	successor	 람보르기니 가야르도, 람보르기니 레벤톤,  << _sbj_ >> , 람보르기니 우라칸  << _obj_ >>  등 람보르기니의 다수 차종의 이름은 투우소의 이름에서 따왔다.
버지니아비치	미국	country	 곡의 음악 프로듀서은 라이프하우스와 음악 프로듀서 주드 콜이 담당하였으며  << _obj_ >>  버지니아 주  << _sbj_ >> 에서 작업하였다.
팀_케이힐	오스트레일리아_축구_국가대표팀	team	 6월 18일,  << _obj_ >> 와의 조별리그 2차전 경기에서, 마르팅스 인디는  << _sbj_ >> 에 의해 실신을 당하였고, 뇌진탕 의심 증세로 병원에 후송되기도 하였다.
조지_2세	조지_3세	successor	 브라운슈바이크의 공작 빌헬름 2세가 후사없이 사망하자, 게오르크의 후손들은 빌헬름의 친할머니 아우구스타가  << _sbj_ >> 의 손녀이자  << _obj_ >> 의 누이였고, 프레데릭 조지의 딸임을 근거로 가까운 친척임을 들어 상속권을 주장했던 것이다.
김인태_(배우)	김수현_(1970년)	child	배우자는 배우  << _sbj_ >> 이며 아들은 영화 배우  << _obj_ >> 이다.
개운사_(서울)	서울특별시	country	서울 보타사 마애보살좌상은  << _obj_ >>  성북구  << _sbj_ >> 의 암자인 보타사 대웅전 뒤쪽 암벽에 조각된 상이다.
1970년_FIFA_월드컵_결승전	브라질_축구_국가대표팀	team	 이로써 두 팀간 월드컵 결승전에서 두 번 이상 만난 최초의 기록이 세워졌고, 이어서  << _obj_ >> 과 이탈리아 축구 국가대표팀가  << _sbj_ >> 과 1994년 FIFA 월드컵 결승전의 월드컵 결승전에 조우하며 이 기록에 동률이 되었다.
마르셀_드사이	프랑스_축구_국가대표팀	team	 그는 2001-02시즌 그의 발전을 계속하였고, 수비 라인의 주전 선수가 되어 당시 팀의 주장이자  << _obj_ >> 에서 활약하던  << _sbj_ >> 와 짝을 이뤘다.
간기남	주상욱	starring	한길로는 한국영화 《 << _sbj_ >> 》에서  << _obj_ >> 이 맡은 배역이다.
독안룡_마사무네	와타나베_켄	starring	또한 호조 도키요리역의  << _obj_ >> 은 1987년 『 << _sbj_ >> 』, 1993~1994년의 『불타오르다』 이후 급성 골수성 백혈병으로 장기요양을 거쳐 복귀 이후에 맡게 된 첫 번째 작품이었고, 『독안룡 마사무네』에서 다테 마사무네의 아버지 다테 데루무네를 맡았던 샤 고쿠메이 역의 기타오오지 킨야와 함께 출연하게 되었다.
마천목	마승_(1393년)	child	  << _sbj_ >> 의 장남  << _obj_ >> 은 세종 때 경상도수사와 판안주목사, 이조참판, 경주부윤 등을 지내며 청백리로 유명했고, 1457년 종1품 숭정대부로 장흥군에 봉해졌다.
유자와_시	일본	country	시모유자와 역은  << _obj_ >>  아키타 현  << _sbj_ >> 에 위치한 동일본 여객철도 오우 본선의 철도역이다.
미국_서부	미국	country	네바다 주는  << _obj_ >>   << _sbj_ >> 에 있는 미국의 주이다.
어사_박문수	조민기	starring	《 << _sbj_ >> 》 -  << _obj_ >>
오늘_(영화)	이정향	director	송혜교는 2011년  << _obj_ >>  감독의 영화 《 << _sbj_ >> 》로 다큐멘터리 PD 다혜 역을 맡아 4년 만에 국내 스크린에 컴백했다.
완풍대군	고려	country	그의 이복 형  << _sbj_ >> 는 이성계의 위화도 회군에 부정적이었고,  << _obj_ >> 에 충성을 바칠 것을 애써 설득하기도 하였으나 끝내 그의 마음을 되돌리지 못했다.
소마_(마니사_주)	터키	country	소마 탄광 폭발 사고는 2014년 5월 13일,  << _obj_ >>  마니사 주  << _sbj_ >> 의 탄광 지하에서 폭발이 일어나 화재가 난 사고이다.
삼성바이오로직스	대한민국	country	삼성바이오에피스는  << _obj_ >> 의 기업으로, 삼성 그룹 계열인  << _sbj_ >> 와 미국의 바이오젠 이 바이오의약품 연구개발, 상용화를 위해 설립한 합작법인이다.
자스민_무이자	성남_FC	team	 그의 형  << _sbj_ >>  역시 축구 선수로  << _obj_ >> 에서 활약하였으며 2016년부터 FC 서울의 피지컬 코치로 재직중이다.
금교진	대구_FC	team	2014년 이웅희와 트레이드로 대전 시티즌으로 이적했으나 부상으로 별다른 활약을 보이지 못한 채 2015시즌 중반  << _sbj_ >> 과 트레이드로  << _obj_ >> 로 이적했으나, 끝내 대구의 1부리그 진출에는 큰 기여를 하지 못한 채, 반년 만에 수원 FC로 이적했다.
모하마드_파힘	유니스_카누니	successor	현 지도자는 전직 아프가니스탄 아프가니스탄의 대통령 부르하누딘 랍바니이고, 전 국방장관  << _sbj_ >> , 월레시 지르가 의장  << _obj_ >> , 압둘 라시드 도스툼 등이 참여하고 있다.
필리피_루이스_카즈미르스키	데포르티보_라코루냐	team	2012년 12월 9일, 망키요는 6-0으로  << _obj_ >> 를 해체한 홈 경기에서 후반 막판에  << _sbj_ >> 와 교체 투입되어 프리메라리가에 처음으로 출전하였다.
휘트비_(온타리오_주)	캐나다	country	레이크쇼어 이스트 선은  << _obj_ >>  온타리오 주 광역 토론토 지역에서 고 트랜싯이 운행하는 일곱 개의 통근 열차 노선 중 하나로, 토론토 시내에 있는 유니언 역 을 출발해 피커링 , 에이젝스 ,  << _sbj_ >> 를 지나 오샤와의 오샤와 역을 잇는 50.5km에 달하는 노선이다.
산티_카소를라	스페인_축구_국가대표팀	team	코케는 런던에서 열린 스페인 U-23 축구 국가대표팀의 일원으로, 조별 리그 3경기에 모두 출전하였으나, 2012년 하계 올림픽 축구 남자. 2013년 8월 14일, 그는 2-0으로 이긴 에콰도르 축구 국가대표팀와의 친선경기에서  << _sbj_ >> 와 교체 투입되어  << _obj_ >> 에 12분간 데뷔하였다.
이토쿠_천황	고쇼_천황	successor	아마토요쓰히메노미코토는 결사팔대의 한 사람인  << _sbj_ >> 의 황후이며,  << _obj_ >> 과 다케시히코쿠시토모세의 생모이다.
드미트리_알레니체프	FC_포르투	team	 프랑스 축구 협회에 소속된 모나코 연고의 클럽 AS 모나코 FC는 포르투갈의  << _obj_ >> 를 상대하였고, 결과는 카를루스 아우베르투 지 지수스, 데쿠,  << _sbj_ >> 가 릴레이 골을 넣은 포르투의 3-0 완승이었다.
코니카	코니카_미놀타	successor	 2003년 8월 5일  << _sbj_ >>  주식회사와 합병하여  << _obj_ >> 가 되었고, 2006년 1월 19일 카메라및 사진 필름 사업을 소니로 매각함을 발표했다.
데쿠	포르투갈_축구_국가대표팀	team	이후  << _obj_ >> 은 8강에서 잉글랜드 축구 국가대표팀와 맞대결을 펼치게 되었으며, 출전이 불가능한 코스티냐와  << _sbj_ >>  없이 잉글랜드를 상대로 승부차기에서 승리해 4강에 진출했다.
카레카	브라질_축구_국가대표팀	team	이후 1989년  << _obj_ >> 과의 1990년 FIFA 월드컵 남아메리카 지역 예선 당시 후반 4분  << _sbj_ >> 의 선제골로 팀이 0-1로 뒤지며 FIFA 월드컵 본선 탈락 위기를 맞게 되었고, 후반 24분경 브라질 서포터였던 호제네리 멜루 두 나시멘투라는 소녀가 관중석에서 부주의하게 폭죽을 던진 것이 자신의 얼굴 근처에서 터지자 마치 자신이 맞은 것처럼 얼굴을 감싸쥐면서 쓰러져 경기를 무산시키려 했다.
최진수_(축구_선수)	울산_현대_축구단	team	졸업 후 2014 시즌을 앞두고, 자유 선발로 FC 안양에 입단한 후, 곧바로  << _sbj_ >> 와 맞트레이드를 통해  << _obj_ >> 로 이적하였다.
박래윤	창원_LG_세이커스	team	친동생은 전  << _obj_ >>  소속  << _sbj_ >> 이다.
그래미스	스웨덴	country	 이탈리아계  << _obj_ >> 인이며 2007년 스웨덴  << _sbj_ >>  시상식에서 올해의 신인상을 수상했다.
파우_가솔	멤피스_그리즐리스	team	샤킬 오닐과 결별이후 몇 년간 우승권 근처에도 조차 머물지 못했으나, 2008년  << _obj_ >> 에서 트레이드된  << _sbj_ >> 과 함께 그해 NBA 준우승, 이듬해인 2009년, NBA 챔피언 결정전의 우승으로 4번째 우승과 1번째 챔피언 결정전 MVP 모두 손에 쥐게 된다.
록키_5	실베스터_스탤론	starring	 1990년에는 영화배우  << _obj_ >> 과 함께  << _sbj_ >> 에 출연하기도 했다.
칼_I._하겐	시브_옌센	successor	 2006년에  << _sbj_ >> 이 사임하면서  << _obj_ >> 이 당대표가 되었다.
김태술	전주_KCC_이지스	team	 이후 2016년 박재현의 맞상대로 서울 삼성 썬더스로 이적했다가  << _sbj_ >> 과의 트레이드로  << _obj_ >> 로 이적했다.
김태술	서울_삼성_썬더스	team	 이후 2016년 박재현의 맞상대로  << _obj_ >> 로 이적했다가  << _sbj_ >> 과의 트레이드로 전주 KCC 이지스로 이적했다.
소림축구	저우싱츠	starring	 원래 안무를 하던 사람이였는데 이소룡을 쏙빼닮은 얼굴 때문에  << _obj_ >> 에게 발탁되어  << _sbj_ >> 에 출연한 것을 계기로 배우로 데뷔했다.
소림축구	저우싱츠	director	 원래 안무를 하던 사람이였는데 이소룡을 쏙빼닮은 얼굴 때문에  << _obj_ >> 에게 발탁되어  << _sbj_ >> 에 출연한 것을 계기로 배우로 데뷔했다.
마우리시오_포체티노	RCD_에스파뇰	team	2009년 7월 27일, 롱카글리아는 라 리가 소속팀  << _obj_ >> 과 임대 계약을 맺어, 감독  << _sbj_ >> 와 과거 보카 주니어 동료 후안 포를린과 함께 같은 국적  스쿼드 5명의 일부가 되었다.
진_문공_(어)	진_환공	successor	 다른 이름으로 타와 오보가 있으며,  << _sbj_ >> 의 아들이자  << _obj_ >> 의 동생이다.
UEFA_챔피언스리그_2014-15	PFC_CSKA_모스크바	team	 이투르베는 2014년 9월 17일에 열린  << _obj_ >> 를 5-1로 이긴  << _sbj_ >>  경기에서 로마 이적후 첫 골을 넣었다.
젤코_바이체타	FC_서울	team	 같은 해  << _obj_ >> 에서 활약했던  << _sbj_ >> 와는 같은 등록명을 사용하여 동일한 선수로 잘못 알려졌다.
네피도	미얀마	country	네피도 연방령은 미얀마의 행정 구역상 수도인  << _sbj_ >> 를 포괄하는 지역으로  << _obj_ >>  중심에 위치한다.
페터르_4세	칼로얀	successor	왕가의 기원, 특히  << _sbj_ >> , 이반 아센 1세,  << _obj_ >>  3형제와 관련된 민족적 배경은 역사가들 사이에서 논쟁이 되고 있다.
기아_세피아	기아_포르테	successor	승용차는 개조된 일반승용차로서 현대 아반떼, 현대 스쿠프, 현대 티뷰론, 현대 티뷰론, 현대 투스카니, 현대 제네시스 쿠페, 기아 K3, 기아 K5,  << _obj_ >> , 현대 베르나, 현대 엘란트라, 기아 슈마, 대우 프린스, 쌍용 코란도, 르노삼성 SM5, 기아 스포티지,  << _sbj_ >> 를 사용하며, 대규모 폭주를 하는 경우에는 견인차와 구급차를 동원하는 경우도 있다.
파비오_카펠로	이탈리아_축구_국가대표팀	team	사키가  << _obj_ >>  감독을 맡기 위해 밀란을 떠나면서  << _sbj_ >> 가 뒤를 이어받았다.
안드레아_페타냐	UC_삼프도리아	team	 팀의 주장을 맡았던 마시모 암브로시니가 ACF 피오렌티나로 팀을 떠났고, 어린 공격수  << _sbj_ >> 는 꾸준한 선발 출전을 위해  << _obj_ >> 로 임대이적했다.
찰스_바클리	피닉스_선즈	team	 1991년 NBA 결승전에서 80년대를 주름잡던 매직 존슨의 로스앤젤레스 레이커스를 꺾고 팀 역사상 최초로 왕좌에 오른 불스는 1992년 클라이드 드렉슬러의 포틀랜드 트레일블레이저스, 93년  << _sbj_ >> , 케빈 존슨의  << _obj_ >> 를 꺾고 3연패 우승을 차지하게 된다.
우르겐치	우즈베키스탄	country	투란 저지에서 가장 큰 도시는 투르크메니스탄의 다쇼구즈와  << _obj_ >> 의 누쿠스와  << _sbj_ >> 이다.
AFC컵_2013	알카디시야_쿠웨이트	team	: 쿠웨이트는 쿠웨이트 SC와  << _obj_ >> 의  << _sbj_ >>  동반 결승 진출로 플레이오프 진출권을 추가로 얻었다.
우르젤_교구	스페인	country	우르젤 또는 라세우두르젤은  << _obj_ >>  카탈루냐 지방의 도시로,  << _sbj_ >> 의 주교좌가 이곳에 위치해 있으며, 우르젤 교구의 수장인 우르젤 주교는 프랑스의 프랑스의 대통령과 함께 안도라의 공동 군주를 맡고 있기도 하다.
리키_루비오	미네소타_팀버울브스	team	 몇몇 포인트 가드들은 여전히 공격에 있어서 많은 자유도가 부여되는데, 보스턴 셀틱스의 라존 론도나 제이슨 키드,  << _obj_ >> 의  << _sbj_ >> 와 같은 선수들이 그렇다.
한스_루터	빌헬름_마르크스	successor	1924년 12월 독일 총선은 1924년 12월 7일 바이마르 공화국에서 치러진 제국의회 선거로,  << _obj_ >>  수상의 중앙당을 중심으로 한 연정 수립이 난항을 겪자, 제2여당이었던 독일민주당을 중심으로 기존 여당이었던 중앙당, 독일민주당에 제2당이었던 독일국민당과 기존 연정이었던 바이에른인민당이 연합한  << _sbj_ >>  내각이 성립하였다.
광복절_특사	유해진	starring	차승원은  << _obj_ >> 과 1999년 영화 《주유소 습격 사건》으로 시작해 2001년 영화 《신라의 달밤》, 2002년 영화 《 << _sbj_ >> 》, 2005년 영화 《혈의 누 》, 2006년 영화 《국경의 남쪽》, 2007년 영화 《이장과 군수》, 2016년 tvN 예능 프로그램 《삼시세끼》에서 호흡을 맞추며 콤비로 활약하였다.
리커창	장가오리	successor	 2013년 5월 1일 현재 국무원 총리는  << _sbj_ >> 이며 4명의 부총리는 상무부총리  << _obj_ >> 와 부총리 류옌둥, 왕양 , 마카이이다.
차의과학대학교	대한민국	country	차광은은  << _obj_ >> 의 의사이고, 현재  << _sbj_ >>  교수이다.
김기희	상하이_뤼디_선화	team	 앨릭스 윌킨슨의 대체 용병으로 에릭 파르탈루를 영입하였고 이규로와 유창현은 각각 서울 이랜드 FC, 성남 FC로 이적하였으며 정훈 ,  << _sbj_ >>  역시 각각 타이 프리미어리그 수판부리 FC와 중국 슈퍼리그  << _obj_ >> 로 이적하였다.
올리버_크롬웰	리처드_크롬웰	child	 1649년에서 1660년까지  << _sbj_ >> 과 그의 아들,  << _obj_ >> 이 통치했다.
올리버_크롬웰	리처드_크롬웰	successor	 1649년에서 1660년까지  << _sbj_ >> 과 그의 아들,  << _obj_ >> 이 통치했다.
료마전	후쿠야마_마사하루	starring	《 << _sbj_ >> 》 : 2010년 - NHK / 료마： << _obj_ >> 
순수_(드라마)	류시원	starring	아울러, 처음 강준상 역이었던  << _obj_ >> 은 배우 심은하와 함께 영화 미술관 옆 동물원에 출연할 뻔 했지만 스크린 데뷔는 뒤로 미뤄졌는데 류시원을 연기자로 데뷔시켜 준 윤석호  감독으로부터 드라마  << _sbj_ >>  출연 러브콜을 받아서 고사한 바 있었다.
메가와티_수카르노푸트리	수실로_밤방_유도요노	successor	 2003년까지는 간접 선거가 이루어지고 있었으나, 헌법 개정으로 2004년 첫 직접 선거가 실시되었으며, 당시 대통령  << _sbj_ >> 와  << _obj_ >> 가 대결하여 유도요노의 승리로 끝났다.
줄리아_길라드	케빈_러드	successor	 현재 실권자는 오스트레일리아 노동당의  << _obj_ >>  제26대 연방 총리로서, 2007년 11월 24일에 치러진 2007년 오스트레일리아 국회의원 총선거에서 존 하워드가 이끌던 오스트레일리아 보수연립에 승리하여 총리로 정식으로 취임하였고, 부총리 겸 교육노동장관  << _sbj_ >> 가 2011년 오스트레일리아 노동당 리더십 투표에서 승리, 총리직을 잠시 이끌었다.
김태영_(1949년)	대한민국	country	 안중근함 진수식에는  << _sbj_ >>   << _obj_ >>  합참의장과 정옥근 해군참모총장 등 군관계자와 현대중공업 임직원, 안중근 의사 숭모회 관계자 등 관계자 등 100여 명이 참석했다.
대한민국_헌법재판소	대한민국_대법원	successor	 이어 “청와대와 대한민국 국회, << _obj_ >> ,  << _sbj_ >> , 대한민국 감사원을 정부세종청사로 이전하고 지방분권을 강화하겠다”라고 밝혔다.
